Is there a way around the upcoming traffic jam	Is there a way around the upcoming traffic jam	[IN:GET_DIRECTIONS Is there a way around the upcoming [SL:OBSTRUCTION_AVOID traffic jam ] ]
how do i avoid the construction on the 101 freeway and still get to work by 9am	how do i avoid the construction on the 101 freeway and still get to work by 9 am	[IN:GET_DIRECTIONS how do i avoid [SL:OBSTRUCTION_AVOID the construction ] on the 101 freeway and still get to [SL:DESTINATION [IN:GET_LOCATION_WORK work ] ] [SL:DATE_TIME_ARRIVAL by 9 am ] ]
Avoid construction	Avoid construction	[IN:UPDATE_DIRECTIONS Avoid [SL:OBSTRUCTION_AVOID construction ] ]
Is there a route with less traffic	Is there a route with less traffic	[IN:UPDATE_DIRECTIONS Is there a route with less [SL:OBSTRUCTION_AVOID traffic ] ]
Are there any ways to avoid traffic this morning	Are there any ways to avoid traffic this morning	[IN:GET_INFO_TRAFFIC Are there any ways to avoid [SL:OBSTRUCTION_AVOID traffic ] [SL:DATE_TIME this morning ] ]
I am thinking of driving to the Opus vineyard in Napa today, what time will be the fastest and have the fewest delays?	I am thinking of driving to the Opus vineyard in Napa today , what time will be the fastest and have the fewest delays ?	[IN:GET_ESTIMATED_DEPARTURE I am thinking of [SL:METHOD_TRAVEL driving ] to [SL:DESTINATION [IN:GET_LOCATION [SL:POINT_ON_MAP the Opus vineyard ] in [SL:LOCATION_MODIFIER Napa ] ] ] [SL:DATE_TIME_DEPARTURE today ] , what time will be the fastest and have the fewest [SL:OBSTRUCTION_AVOID delays ] ? ]
What time should I leave if I want to avoid traffic and get to the office by 8am	What time should I leave if I want to avoid traffic and get to the office by 8 am	[IN:GET_ESTIMATED_DEPARTURE What time should I leave if I want to avoid [SL:OBSTRUCTION_AVOID traffic ] and get to [SL:DESTINATION [IN:GET_LOCATION_WORK the office ] ] [SL:DATE_TIME_ARRIVAL by 8 am ] ]
Find route with least amount of traffic	Find route with least amount of traffic	[IN:GET_DIRECTIONS Find route with least amount of [SL:OBSTRUCTION_AVOID traffic ] ]
How long will it take to get around the road construction on Mercer Avenue and get to my appointment downtown?	How long will it take to get around the road construction on Mercer Avenue and get to my appointment downtown ?	[IN:GET_ESTIMATED_DURATION How long will it take to get around [SL:OBSTRUCTION_AVOID the road construction ] on [SL:PATH_AVOID Mercer Avenue ] and get to [SL:DESTINATION [IN:GET_EVENT [SL:ORGANIZER_EVENT my ] [SL:CATEGORY_EVENT appointment ] [SL:LOCATION downtown ] ] ] ? ]
Can I drive home without any wrecks	Can I drive home without any wrecks	[IN:GET_DIRECTIONS Can I [SL:METHOD_TRAVEL drive ] [SL:DESTINATION [IN:GET_LOCATION_HOME home ] ] without any [SL:OBSTRUCTION_AVOID wrecks ] ]
Get directions to downtown Akron without passing construction	Get directions to downtown Akron without passing construction	[IN:GET_DIRECTIONS Get directions to [SL:DESTINATION downtown Akron ] without passing [SL:OBSTRUCTION_AVOID construction ] ]
Calculate arrival time to work if I route around the construction ahead.	Calculate arrival time to work if I route around the construction ahead .	[IN:GET_ESTIMATED_ARRIVAL Calculate arrival time to [SL:DESTINATION [IN:GET_LOCATION_WORK work ] ] if I route around [SL:OBSTRUCTION_AVOID the construction ] ahead . ]
Give me a less traffic alternative than Keystone Ave	Give me a less traffic alternative than Keystone Ave	[IN:UPDATE_DIRECTIONS Give me a less [SL:OBSTRUCTION_AVOID traffic ] alternative than [SL:PATH_AVOID Keystone Ave ] ]
Check alternate route to AMC cinema to avoid accident on route 10.	Check alternate route to AMC cinema to avoid accident on route 10 .	[IN:GET_DIRECTIONS Check alternate route to [SL:DESTINATION [IN:GET_LOCATION [SL:POINT_ON_MAP AMC cinema ] ] ] to avoid [SL:OBSTRUCTION_AVOID accident on route 10 ] . ]
How can I get around the traffic	How can I get around the traffic	[IN:GET_DIRECTIONS How can I get around [SL:OBSTRUCTION_AVOID the traffic ] ]
Get directions to PDX airport in Portland without passing road construction.  Leaving at noon.	Get directions to PDX airport in Portland without passing road construction . Leaving at noon .	[IN:GET_DIRECTIONS Get directions to [SL:DESTINATION [IN:GET_LOCATION [SL:POINT_ON_MAP PDX airport ] in [SL:LOCATION_MODIFIER Portland ] ] ] without passing [SL:OBSTRUCTION_AVOID road construction ] . Leaving [SL:DATE_TIME_DEPARTURE at noon ] . ]
If I leave work at 3pm what time will I get to The Forum avoiding construction work	If I leave work at 3 pm what time will I get to The Forum avoiding construction work	[IN:GET_ESTIMATED_ARRIVAL If I leave [SL:SOURCE [IN:GET_LOCATION_WORK work ] ] [SL:DATE_TIME_DEPARTURE at 3 pm ] what time will I get to [SL:DESTINATION [IN:GET_LOCATION [SL:POINT_ON_MAP The Forum ] ] ] avoiding [SL:OBSTRUCTION_AVOID construction work ] ]
Need directions from home to the airport without traffic, arriving at 4pm	Need directions from home to the airport without traffic , arriving at 4 pm	[IN:GET_DIRECTIONS Need directions from [SL:SOURCE [IN:GET_LOCATION_HOME home ] ] to [SL:DESTINATION [IN:GET_LOCATION [SL:CATEGORY_LOCATION the airport ] ] ] without [SL:OBSTRUCTION_AVOID traffic ] , arriving [SL:DATE_TIME_ARRIVAL at 4 pm ] ]
What is the best route to avoid traffic on my way home	What is the best route to avoid traffic on my way home	[IN:GET_DIRECTIONS What is the best route to avoid [SL:OBSTRUCTION_AVOID traffic ] on my way [SL:DESTINATION [IN:GET_LOCATION_HOME home ] ] ]
which is the fastest way to school avoid accident blockage	which is the fastest way to school avoid accident blockage	[IN:GET_DIRECTIONS which is the fastest way to [SL:DESTINATION [IN:GET_LOCATION_SCHOOL school ] ] avoid [SL:OBSTRUCTION_AVOID accident blockage ] ]
What route has the least traffic currently	What route has the least traffic currently	[IN:GET_DIRECTIONS What route has the least [SL:OBSTRUCTION_AVOID traffic ] currently ]
Reroute me around accidents	Reroute me around accidents	[IN:UPDATE_DIRECTIONS Reroute me around [SL:OBSTRUCTION_AVOID accidents ] ]
How long will it take me to get to RBA without traffic	How long will it take me to get to RBA without traffic	[IN:GET_ESTIMATED_DURATION How long will it take me to get to [SL:DESTINATION [IN:GET_LOCATION [SL:POINT_ON_MAP RBA ] ] ] without [SL:OBSTRUCTION_AVOID traffic ] ]
Avoiding the slow-down on I-64, how long should it take me to get to the northside Kroger?	Avoiding the slow - down on I - 64 , how long should it take me to get to the northside Kroger ?	[IN:GET_ESTIMATED_DURATION Avoiding [SL:OBSTRUCTION_AVOID the slow - down ] on [SL:PATH I - 64 ] , how long should it take me to get to [SL:DESTINATION [IN:GET_LOCATION the [SL:LOCATION_MODIFIER northside ] [SL:POINT_ON_MAP Kroger ] ] ] ? ]
How can I get to work while avoiding the most people	How can I get to work while avoiding the most people	[IN:GET_DIRECTIONS How can I get to [SL:DESTINATION [IN:GET_LOCATION_WORK work ] ] while avoiding the most [SL:OBSTRUCTION_AVOID people ] ]
What's the quickest way to get through traffic	What 's the quickest way to get through traffic	[IN:GET_DIRECTIONS What 's the quickest way to get through [SL:OBSTRUCTION_AVOID traffic ] ]
I need a way with easy traffic	I need a way with easy traffic	[IN:GET_DIRECTIONS I need a way with easy [SL:OBSTRUCTION_AVOID traffic ] ]
which highway has the least traffic right now	which highway has the least traffic right now	[IN:GET_INFO_TRAFFIC which [SL:LOCATION [IN:GET_LOCATION [SL:CATEGORY_LOCATION highway ] ] ] has the least [SL:OBSTRUCTION_AVOID traffic ] [SL:DATE_TIME right now ] ]
Best route to avoid traffic going to the Camden aquarium	Best route to avoid traffic going to the Camden aquarium	[IN:GET_DIRECTIONS Best route to avoid [SL:OBSTRUCTION_AVOID traffic ] going to [SL:DESTINATION [IN:GET_LOCATION [SL:POINT_ON_MAP the Camden aquarium ] ] ] ]
SHOULD I LEAVE EARLY TO AVOID TRAFFIC	SHOULD I LEAVE EARLY TO AVOID TRAFFIC	[IN:GET_ESTIMATED_DEPARTURE SHOULD I LEAVE EARLY TO AVOID [SL:OBSTRUCTION_AVOID TRAFFIC ] ]
If I leave in 15 minutes, what route home has the least amount of traffic?	If I leave in 15 minutes , what route home has the least amount of traffic ?	[IN:GET_DIRECTIONS If I leave [SL:DATE_TIME_DEPARTURE in 15 minutes ] , what route [SL:DESTINATION [IN:GET_LOCATION_HOME home ] ] has the least amount of [SL:OBSTRUCTION_AVOID traffic ] ? ]
Can I avoid traffic	Can I avoid traffic	[IN:GET_DIRECTIONS Can I avoid [SL:OBSTRUCTION_AVOID traffic ] ]
Is there a way to get from my house to the mall and avoid construction delays	Is there a way to get from my house to the mall and avoid construction delays	[IN:GET_DIRECTIONS Is there a way to get from [SL:SOURCE [IN:GET_LOCATION_HOME [SL:CONTACT my ] house ] ] to [SL:DESTINATION [IN:GET_LOCATION [SL:CATEGORY_LOCATION the mall ] ] ] and avoid [SL:OBSTRUCTION_AVOID construction delays ] ]
what time should i leave to avoid traffic in DC	what time should i leave to avoid traffic in DC	[IN:GET_ESTIMATED_DEPARTURE what time should i leave to avoid [SL:OBSTRUCTION_AVOID traffic ] in [SL:LOCATION DC ] ]
give me another route to avoid traffic	give me another route to avoid traffic	[IN:UPDATE_DIRECTIONS give me another route to avoid [SL:OBSTRUCTION_AVOID traffic ] ]
get me the directions to the aquarium with minimal delays	get me the directions to the aquarium with minimal delays	[IN:GET_DIRECTIONS get me the directions to [SL:DESTINATION [IN:GET_LOCATION [SL:CATEGORY_LOCATION the aquarium ] ] ] with minimal [SL:OBSTRUCTION_AVOID delays ] ]
Give me the route home with the least traffic	Give me the route home with the least traffic	[IN:GET_DIRECTIONS Give me the route [SL:DESTINATION [IN:GET_LOCATION_HOME home ] ] with the least [SL:OBSTRUCTION_AVOID traffic ] ]
What's the best time to leave to avoid traffic in Madison	What 's the best time to leave to avoid traffic in Madison	[IN:GET_ESTIMATED_DEPARTURE What 's the best time to leave to avoid [SL:OBSTRUCTION_AVOID traffic ] in [SL:LOCATION Madison ] ]
What route can I take to avoid traffic at 6pm?	What route can I take to avoid traffic at 6 pm ?	[IN:GET_DIRECTIONS What route can I take to avoid [SL:OBSTRUCTION_AVOID traffic ] [SL:DATE_TIME_DEPARTURE at 6 pm ] ? ]
Is there a route from Onondaga St to 2300 Degrees Gathering without construction?	Is there a route from Onondaga St to 2300 Degrees Gathering without construction ?	[IN:GET_DIRECTIONS Is there a route from [SL:SOURCE Onondaga St ] to [SL:DESTINATION [IN:GET_EVENT [SL:LOCATION [IN:GET_LOCATION [SL:POINT_ON_MAP 2300 Degrees ] ] ] [SL:CATEGORY_EVENT Gathering ] ] ] without [SL:OBSTRUCTION_AVOID construction ] ? ]
Avoid major traffic delays	Avoid major traffic delays	[IN:UPDATE_DIRECTIONS Avoid major [SL:OBSTRUCTION_AVOID traffic delays ] ]
Give me directions that avoid road debris from my apartment to Bike World, Inc.	Give me directions that avoid road debris from my apartment to Bike World , Inc .	[IN:GET_DIRECTIONS Give me directions that avoid [SL:OBSTRUCTION_AVOID road debris ] from [SL:SOURCE [IN:GET_LOCATION_HOME [SL:CONTACT my ] apartment ] ] to [SL:DESTINATION [IN:GET_LOCATION [SL:POINT_ON_MAP Bike World , Inc ] ] ] . ]
Give me directions to the downtown festival without passing construction.	Give me directions to the downtown festival without passing construction .	[IN:GET_DIRECTIONS Give me directions to [SL:DESTINATION [IN:GET_EVENT the [SL:LOCATION downtown ] [SL:CATEGORY_EVENT festival ] ] ] without passing [SL:OBSTRUCTION_AVOID construction ] . ]
Find best alternate route to avoid traffic	Find best alternate route to avoid traffic	[IN:UPDATE_DIRECTIONS Find best alternate route to avoid [SL:OBSTRUCTION_AVOID traffic ] ]
directions to the nearest hospital that is less then 10 minutes away avoiding all traffic and construction	directions to the nearest hospital that is less then 10 minutes away avoiding all traffic and construction	[IN:GET_DIRECTIONS directions to [SL:DESTINATION [IN:GET_LOCATION the [SL:LOCATION_MODIFIER nearest ] [SL:CATEGORY_LOCATION hospital ] ] ] that is [SL:DATE_TIME_ARRIVAL less then 10 minutes ] away avoiding all [SL:OBSTRUCTION_AVOID traffic ] and [SL:OBSTRUCTION_AVOID construction ] ]
Best route to work to avoid heavy traffic	Best route to work to avoid heavy traffic	[IN:GET_DIRECTIONS Best route to [SL:DESTINATION [IN:GET_LOCATION_WORK work ] ] to avoid heavy [SL:OBSTRUCTION_AVOID traffic ] ]
What route can I take to avoid traffic in Champaign during lunch?	What route can I take to avoid traffic in Champaign during lunch ?	[IN:GET_DIRECTIONS What route can I take to avoid [SL:OBSTRUCTION_AVOID traffic ] in [SL:LOCATION [IN:GET_LOCATION [SL:LOCATION_MODIFIER Champaign ] ] ] [SL:DATE_TIME_DEPARTURE during lunch ] ? ]
Is there a route on my way home with no traffic	Is there a route on my way home with no traffic	[IN:GET_DIRECTIONS Is there a route on my way [SL:DESTINATION [IN:GET_LOCATION_HOME home ] ] with no [SL:OBSTRUCTION_AVOID traffic ] ]
avoid construction areas	avoid construction areas	[IN:GET_DIRECTIONS avoid [SL:OBSTRUCTION_AVOID construction ] areas ]
how long will it take for me to go to Assis without passing any constructions?	how long will it take for me to go to Assis without passing any constructions ?	[IN:GET_ESTIMATED_DURATION how long will it take for me to go to [SL:DESTINATION Assis ] without passing any [SL:OBSTRUCTION_AVOID constructions ] ? ]
Send me an alternate route with less traffic	Send me an alternate route with less traffic	[IN:UPDATE_DIRECTIONS Send me an alternate route with less [SL:OBSTRUCTION_AVOID traffic ] ]
What route from Norfolk State to Thomas Nelson has the least amount of traffic?	What route from Norfolk State to Thomas Nelson has the least amount of traffic ?	[IN:GET_DIRECTIONS What route from [SL:SOURCE [IN:GET_LOCATION [SL:POINT_ON_MAP Norfolk State ] ] ] to [SL:DESTINATION [IN:GET_LOCATION [SL:POINT_ON_MAP Thomas Nelson ] ] ] has the least amount of [SL:OBSTRUCTION_AVOID traffic ] ? ]
Where is the least traffic at for my drive home from work	Where is the least traffic at for my drive home from work	[IN:GET_DIRECTIONS Where is the least [SL:OBSTRUCTION_AVOID traffic ] at for my [SL:METHOD_TRAVEL drive ] [SL:DESTINATION [IN:GET_LOCATION_HOME home ] ] from [SL:SOURCE [IN:GET_LOCATION_WORK work ] ] ]
Best route to avoid congestion	Best route to avoid congestion	[IN:GET_DIRECTIONS Best route to avoid [SL:OBSTRUCTION_AVOID congestion ] ]
how can i avoid the traffic in the morning time	how can i avoid the traffic in the morning time	[IN:GET_DIRECTIONS how can i avoid [SL:OBSTRUCTION_AVOID the traffic ] [SL:DATE_TIME_DEPARTURE in the morning time ] ]
No construction on 101, how long will I take to get to Palo Alto?	No construction on 101 , how long will I take to get to Palo Alto ?	[IN:GET_ESTIMATED_DURATION No [SL:OBSTRUCTION_AVOID construction ] on [SL:PATH 101 ] , how long will I take to get to [SL:DESTINATION Palo Alto ] ? ]
If I take route 36 can I avoid traffic	If I take route 36 can I avoid traffic	[IN:GET_DIRECTIONS If I take [SL:PATH route 36 ] can I avoid [SL:OBSTRUCTION_AVOID traffic ] ]
Get directions to downtown Pittsburgh without passing construction	Get directions to downtown Pittsburgh without passing construction	[IN:GET_DIRECTIONS Get directions to [SL:DESTINATION downtown Pittsburgh ] without passing [SL:OBSTRUCTION_AVOID construction ] ]
What's the least heavy traffic route home	What 's the least heavy traffic route home	[IN:GET_DIRECTIONS What 's the least heavy [SL:OBSTRUCTION_AVOID traffic ] route [SL:DESTINATION [IN:GET_LOCATION_HOME home ] ] ]
Get directions to downtown Austin without passing construction	Get directions to downtown Austin without passing construction	[IN:GET_DIRECTIONS Get directions to [SL:DESTINATION downtown Austin ] without passing [SL:OBSTRUCTION_AVOID construction ] ]
best route to avoid Traffic please	best route to avoid Traffic please	[IN:GET_DIRECTIONS best route to avoid [SL:OBSTRUCTION_AVOID Traffic ] please ]
How do I avoid traffic in Honolulu	How do I avoid traffic in Honolulu	[IN:GET_INFO_TRAFFIC How do I avoid [SL:OBSTRUCTION_AVOID traffic ] in [SL:LOCATION Honolulu ] ]
I'm getting a lot of traffic, can you show me another way to my destination	I'm getting a lot of traffic , can you show me another way to my destination	[IN:UPDATE_DIRECTIONS I'm getting a lot of [SL:OBSTRUCTION_AVOID traffic ] , can you show me another way to [SL:DESTINATION my destination ] ]
Give me a route without detours	Give me a route without detours	[IN:UPDATE_DIRECTIONS Give me a route without [SL:OBSTRUCTION_AVOID detours ] ]
best alternative route to miss heavy traffic	best alternative route to miss heavy traffic	[IN:GET_DIRECTIONS best alternative route to miss heavy [SL:OBSTRUCTION_AVOID traffic ] ]
What is the best time to leave to avoid traffic on my route	What is the best time to leave to avoid traffic on my route	[IN:GET_ESTIMATED_DEPARTURE What is the best time to leave to avoid [SL:OBSTRUCTION_AVOID traffic ] on my route ]
avaoiding downed power lines, get me driving directions to prawns supermarket from the barbers shop	avaoiding downed power lines , get me driving directions to prawns supermarket from the barbers shop	[IN:GET_DIRECTIONS avaoiding [SL:OBSTRUCTION_AVOID downed power lines ] , get me [SL:METHOD_TRAVEL driving ] directions to [SL:DESTINATION [IN:GET_LOCATION [SL:POINT_ON_MAP prawns supermarket ] ] ] from [SL:SOURCE [IN:GET_LOCATION [SL:CATEGORY_LOCATION the barbers shop ] ] ] ]
What route home has the least traffic	What route home has the least traffic	[IN:GET_DIRECTIONS What route [SL:DESTINATION [IN:GET_LOCATION_HOME home ] ] has the least [SL:OBSTRUCTION_AVOID traffic ] ]
Is there a detour I could take to avoid rush hour traffic tonight?	Is there a detour I could take to avoid rush hour traffic tonight ?	[IN:GET_DIRECTIONS Is there a [SL:PATH detour ] I could take to avoid [SL:OBSTRUCTION_AVOID rush hour traffic ] [SL:DATE_TIME_DEPARTURE tonight ] ? ]
Which way should I go to get to work during the construction?	Which way should I go to get to work during the construction ?	[IN:GET_DIRECTIONS Which way should I go to get to [SL:DESTINATION [IN:GET_LOCATION_WORK work ] ] during [SL:OBSTRUCTION_AVOID the construction ] ? ]
tell me the best possible time required to reach Alameda avoiding construction work.	tell me the best possible time required to reach Alameda avoiding construction work .	[IN:GET_ESTIMATED_DURATION tell me the best possible time required to reach [SL:DESTINATION Alameda ] avoiding [SL:OBSTRUCTION_AVOID construction work ] . ]
How do I avoid construction zones	How do I avoid construction zones	[IN:GET_DIRECTIONS How do I avoid [SL:OBSTRUCTION_AVOID construction zones ] ]
What route should I take to avoid traffic	What route should I take to avoid traffic	[IN:GET_DIRECTIONS What route should I take to avoid [SL:OBSTRUCTION_AVOID traffic ] ]
Best route to avoid traffic from orlando to Miami	Best route to avoid traffic from orlando to Miami	[IN:GET_DIRECTIONS Best route to avoid [SL:OBSTRUCTION_AVOID traffic ] from [SL:SOURCE orlando ] to [SL:DESTINATION Miami ] ]
Which highways are least congested in my area	Which highways are least congested in my area	[IN:GET_INFO_TRAFFIC Which [SL:LOCATION [IN:GET_LOCATION [SL:CATEGORY_LOCATION highways ] ] ] are least [SL:OBSTRUCTION_AVOID congested ] in [SL:LOCATION [IN:GET_LOCATION [SL:LOCATION_USER my area ] ] ] ]
Is there a way to avoid the traffic in New Albany today	Is there a way to avoid the traffic in New Albany today	[IN:GET_DIRECTIONS Is there a way to avoid [SL:OBSTRUCTION_AVOID the traffic ] in [SL:LOCATION [IN:GET_LOCATION [SL:LOCATION_MODIFIER New Albany ] ] ] [SL:DATE_TIME_DEPARTURE today ] ]
Can I get to Rockland by 5:30pm without delays from the storm?	Can I get to Rockland by 5 : 30 pm without delays from the storm ?	[IN:GET_ESTIMATED_ARRIVAL Can I get to [SL:DESTINATION Rockland ] [SL:DATE_TIME_ARRIVAL by 5 : 30 pm ] without [SL:OBSTRUCTION_AVOID delays from the storm ] ? ]
Quickest route through traffic home	Quickest route through traffic home	[IN:GET_DIRECTIONS Quickest route through [SL:OBSTRUCTION_AVOID traffic ] [SL:DESTINATION [IN:GET_LOCATION_HOME home ] ] ]
Can you give me directions to get around this traffic	Can you give me directions to get around this traffic	[IN:GET_DIRECTIONS Can you give me directions to get around [SL:OBSTRUCTION_AVOID this traffic ] ]
How can I get to Manhattan by 7 and avoid construction	How can I get to Manhattan by 7 and avoid construction	[IN:GET_DIRECTIONS How can I get to [SL:DESTINATION Manhattan ] [SL:DATE_TIME_ARRIVAL by 7 ] and avoid [SL:OBSTRUCTION_AVOID construction ] ]
Avoid construction on my way to work	Avoid construction on my way to work	[IN:GET_DIRECTIONS Avoid [SL:OBSTRUCTION_AVOID construction ] on my way to [SL:DESTINATION [IN:GET_LOCATION_WORK work ] ] ]
What's the best way to arrive at Morumbi stadium without traffic?	What 's the best way to arrive at Morumbi stadium without traffic ?	[IN:GET_DIRECTIONS What 's the best way to arrive at [SL:DESTINATION [IN:GET_LOCATION [SL:POINT_ON_MAP Morumbi stadium ] ] ] without [SL:OBSTRUCTION_AVOID traffic ] ? ]
Is there any alternate commute to avoid traffic	Is there any alternate commute to avoid traffic	[IN:UPDATE_DIRECTIONS Is there any alternate commute to avoid [SL:OBSTRUCTION_AVOID traffic ] ]
What is the best route to take to Ocean City MD avoiding construction	What is the best route to take to Ocean City MD avoiding construction	[IN:GET_DIRECTIONS What is the best route to take to [SL:DESTINATION Ocean City MD ] avoiding [SL:OBSTRUCTION_AVOID construction ] ]
If I leave Portland at 1, what time can I get to Salem and avoid construction?	If I leave Portland at 1 , what time can I get to Salem and avoid construction ?	[IN:GET_ESTIMATED_ARRIVAL If I leave [SL:SOURCE Portland ] [SL:DATE_TIME_DEPARTURE at 1 ] , what time can I get to [SL:DESTINATION Salem ] and avoid [SL:OBSTRUCTION_AVOID construction ] ? ]
Can you give me the fastest route to get to Colorado Springs that avoid going through any construction zones?	Can you give me the fastest route to get to Colorado Springs that avoid going through any construction zones ?	[IN:GET_DIRECTIONS Can you give me the fastest route to get to [SL:DESTINATION Colorado Springs ] that avoid going through any [SL:OBSTRUCTION_AVOID construction zones ] ? ]
Which route to work has the least traffic	Which route to work has the least traffic	[IN:GET_DIRECTIONS Which route to [SL:DESTINATION [IN:GET_LOCATION_WORK work ] ] has the least [SL:OBSTRUCTION_AVOID traffic ] ]
Best way to avoid traffic in Maitland	Best way to avoid traffic in Maitland	[IN:GET_DIRECTIONS Best way to avoid [SL:OBSTRUCTION_AVOID traffic ] in [SL:LOCATION [IN:GET_LOCATION [SL:LOCATION_MODIFIER Maitland ] ] ] ]
directions to portland maine leaving my house at 6 am and avoiding road construction	directions to portland maine leaving my house at 6 am and avoiding road construction	[IN:GET_DIRECTIONS directions to [SL:DESTINATION portland maine ] leaving [SL:SOURCE [IN:GET_LOCATION_HOME [SL:CONTACT my ] house ] ] [SL:DATE_TIME_DEPARTURE at 6 am ] and avoiding [SL:OBSTRUCTION_AVOID road construction ] ]
Can you tell me if there is a more scenic route where there is less traffic	Can you tell me if there is a more scenic route where there is less traffic	[IN:UPDATE_DIRECTIONS Can you tell me if there is a more scenic route where there is less [SL:OBSTRUCTION_AVOID traffic ] ]
Is there anyway to avoid traffic	Is there anyway to avoid traffic	[IN:GET_DIRECTIONS Is there anyway to avoid [SL:OBSTRUCTION_AVOID traffic ] ]
can i avoid traffic on my drive	can i avoid traffic on my drive	[IN:GET_DIRECTIONS can i avoid [SL:OBSTRUCTION_AVOID traffic ] on my [SL:METHOD_TRAVEL drive ] ]
How do I bypass the 10 mile Road congestion at 94	How do I bypass the 10 mile Road congestion at 94	[IN:GET_DIRECTIONS How do I bypass [SL:OBSTRUCTION_AVOID the 10 mile Road congestion ] at [SL:PATH_AVOID 94 ] ]
Reroute past accident on 77 to work	Reroute past accident on 77 to work	[IN:UPDATE_DIRECTIONS Reroute past [SL:OBSTRUCTION_AVOID accident ] on [SL:PATH_AVOID 77 ] to [SL:DESTINATION [IN:GET_LOCATION_WORK work ] ] ]
What is the best route to drive from A st and Westmoreland to Childrens Hospital without traffic?	What is the best route to drive from A st and Westmoreland to Childrens Hospital without traffic ?	[IN:GET_DIRECTIONS What is the best route to [SL:METHOD_TRAVEL drive ] from [SL:SOURCE [IN:GET_LOCATION [SL:LOCATION A st ] and [SL:LOCATION Westmoreland ] ] ] to [SL:DESTINATION [IN:GET_LOCATION [SL:POINT_ON_MAP Childrens Hospital ] ] ] without [SL:OBSTRUCTION_AVOID traffic ] ? ]
Get directions to downtown Covington without passing construction	Get directions to downtown Covington without passing construction	[IN:GET_DIRECTIONS Get directions to [SL:DESTINATION downtown Covington ] without passing [SL:OBSTRUCTION_AVOID construction ] ]
What is the route with the least amount of traffic to get to downtown to the Hollywood Bowl	What is the route with the least amount of traffic to get to downtown to the Hollywood Bowl	[IN:GET_DIRECTIONS What is the route with the least amount of [SL:OBSTRUCTION_AVOID traffic ] to get to [SL:DESTINATION [IN:GET_LOCATION [SL:LOCATION_MODIFIER downtown ] to [SL:POINT_ON_MAP the Hollywood Bowl ] ] ] ]
New route to avoid that accident	New route to avoid that accident	[IN:UPDATE_DIRECTIONS New route to avoid [SL:OBSTRUCTION_AVOID that accident ] ]
Get the directions to the Bel Air Mall with the less traffic.	Get the directions to the Bel Air Mall with the less traffic .	[IN:GET_DIRECTIONS Get the directions to [SL:DESTINATION [IN:GET_LOCATION [SL:POINT_ON_MAP the Bel Air Mall ] ] ] with the less [SL:OBSTRUCTION_AVOID traffic ] . ]
Is there a route I can take without traffic	Is there a route I can take without traffic	[IN:GET_DIRECTIONS Is there a route I can take without [SL:OBSTRUCTION_AVOID traffic ] ]
Should I use the Toll way to avoid a traffic	Should I use the Toll way to avoid a traffic	[IN:GET_DIRECTIONS Should I use [SL:PATH the Toll way ] to avoid a [SL:OBSTRUCTION_AVOID traffic ] ]
Reroute me around this traffic jam please	Reroute me around this traffic jam please	[IN:UPDATE_DIRECTIONS Reroute me around [SL:OBSTRUCTION_AVOID this traffic jam ] please ]
can i take a different route to avoid this traffic	can i take a different route to avoid this traffic	[IN:UPDATE_DIRECTIONS can i take a different route to avoid [SL:OBSTRUCTION_AVOID this traffic ] ]
I have to be at Browns stadium by noon and I am leaving my house. Could you give me directions that will miss the most traffic	I have to be at Browns stadium by noon and I am leaving my house . Could you give me directions that will miss the most traffic	[IN:GET_DIRECTIONS I have to be at [SL:DESTINATION [IN:GET_LOCATION [SL:POINT_ON_MAP Browns stadium ] ] ] [SL:DATE_TIME_ARRIVAL by noon ] and I am leaving [SL:SOURCE [IN:GET_LOCATION_HOME [SL:CONTACT my ] house ] ] . Could you give me directions that will miss the most [SL:OBSTRUCTION_AVOID traffic ] ]
Is there an alternative traffic route with less traffic that I can take	Is there an alternative traffic route with less traffic that I can take	[IN:UPDATE_DIRECTIONS Is there an alternative [SL:OBSTRUCTION_AVOID traffic ] route with less traffic that I can take ]
Steer me around any detours	Steer me around any detours	[IN:UPDATE_DIRECTIONS Steer me around any [SL:OBSTRUCTION_AVOID detours ] ]
NO TRAFFIC PLEASE	NO TRAFFIC PLEASE	[IN:GET_DIRECTIONS NO [SL:OBSTRUCTION_AVOID TRAFFIC ] PLEASE ]
How can I get to work and avoid the downed power lines	How can I get to work and avoid the downed power lines	[IN:GET_DIRECTIONS How can I get to [SL:DESTINATION [IN:GET_LOCATION_WORK work ] ] and avoid [SL:OBSTRUCTION_AVOID the downed power lines ] ]
Going to Redlands, when's the best time to avoid traffic?	Going to Redlands , when 's the best time to avoid traffic ?	[IN:GET_ESTIMATED_DEPARTURE Going to [SL:DESTINATION Redlands ] , when 's the best time to avoid [SL:OBSTRUCTION_AVOID traffic ] ? ]
Avoid all streets with heavy traffic	Avoid all streets with heavy traffic	[IN:GET_DIRECTIONS Avoid all streets with heavy [SL:OBSTRUCTION_AVOID traffic ] ]
Is there a way around this traffic jam	Is there a way around this traffic jam	[IN:GET_DIRECTIONS Is there a way around [SL:OBSTRUCTION_AVOID this traffic jam ] ]
How can I avoid the traffic	How can I avoid the traffic	[IN:GET_DIRECTIONS How can I avoid [SL:OBSTRUCTION_AVOID the traffic ] ]
find me the way to Las vegas avoiding any construction zones.	find me the way to Las vegas avoiding any construction zones .	[IN:GET_DIRECTIONS find me the way to [SL:DESTINATION Las vegas ] avoiding any [SL:OBSTRUCTION_AVOID construction zones ] . ]
Give me a route around traffic	Give me a route around traffic	[IN:GET_DIRECTIONS Give me a route around [SL:OBSTRUCTION_AVOID traffic ] ]
Alternate route with no traffic	Alternate route with no traffic	[IN:UPDATE_DIRECTIONS Alternate route with no [SL:OBSTRUCTION_AVOID traffic ] ]
How do I get around the slow traffic in Los Angeles?	How do I get around the slow traffic in Los Angeles ?	[IN:GET_DIRECTIONS How do I get around the slow [SL:OBSTRUCTION_AVOID traffic ] in Los Angeles ? ]
Tell me how long it will take to get to the wharf from here avoiding construction	Tell me how long it will take to get to the wharf from here avoiding construction	[IN:GET_ESTIMATED_DURATION Tell me how long it will take to get to [SL:DESTINATION [IN:GET_LOCATION [SL:CATEGORY_LOCATION the wharf ] ] ] from [SL:SOURCE [IN:GET_LOCATION [SL:LOCATION_USER here ] ] ] avoiding [SL:OBSTRUCTION_AVOID construction ] ]
Which highway with the lightest traffic should I take to work this morning	Which highway with the lightest traffic should I take to work this morning	[IN:GET_DIRECTIONS Which [SL:PATH [IN:GET_LOCATION [SL:CATEGORY_LOCATION highway ] ] ] with the lightest [SL:OBSTRUCTION_AVOID traffic ] should I take to [SL:DESTINATION [IN:GET_LOCATION_WORK work ] ] [SL:DATE_TIME_DEPARTURE this morning ] ]
Which route has the lightest traffic	Which route has the lightest traffic	[IN:GET_DIRECTIONS Which route has the lightest [SL:OBSTRUCTION_AVOID traffic ] ]
How do I avoid traffic on my way home?	How do I avoid traffic on my way home ?	[IN:GET_DIRECTIONS How do I avoid [SL:OBSTRUCTION_AVOID traffic ] on my way [SL:DESTINATION [IN:GET_LOCATION_HOME home ] ] ? ]
route me around traffic	route me around traffic	[IN:GET_DIRECTIONS route me around [SL:OBSTRUCTION_AVOID traffic ] ]
Which route home has the least traffic right now	Which route home has the least traffic right now	[IN:GET_DIRECTIONS Which route [SL:DESTINATION [IN:GET_LOCATION_HOME home ] ] has the least [SL:OBSTRUCTION_AVOID traffic ] [SL:DATE_TIME_DEPARTURE right now ] ]
How do I go around the detours and still make it on time for the Cher concert at 8 pm?	How do I go around the detours and still make it on time for the Cher concert at 8 pm ?	[IN:GET_DIRECTIONS How do I go around [SL:OBSTRUCTION_AVOID the detours ] and still make it on time for [SL:DESTINATION [IN:GET_EVENT the [SL:NAME_EVENT Cher ] [SL:CATEGORY_EVENT concert ] [SL:DATE_TIME at 8 pm ] ] ] ? ]
Avoid construction on route	Avoid construction on route	[IN:GET_DIRECTIONS Avoid [SL:OBSTRUCTION_AVOID construction ] on route ]
I need directions to get to Newark, DE with the least traffic.	I need directions to get to Newark , DE with the least traffic .	[IN:GET_DIRECTIONS I need directions to get to [SL:DESTINATION Newark , DE ] with the least [SL:OBSTRUCTION_AVOID traffic ] . ]
Is there an alternate route to avoid construction on I-19	Is there an alternate route to avoid construction on I - 19	[IN:UPDATE_DIRECTIONS Is there an alternate route to avoid [SL:OBSTRUCTION_AVOID construction ] on [SL:PATH_AVOID I - 19 ] ]
Which streets have the least traffic in my area	Which streets have the least traffic in my area	[IN:GET_INFO_TRAFFIC Which streets have the least [SL:OBSTRUCTION_AVOID traffic ] in [SL:LOCATION [IN:GET_LOCATION [SL:LOCATION_USER my area ] ] ] ]
please avoid any car accidents on the highway	please avoid any car accidents on the highway	[IN:GET_DIRECTIONS please avoid any [SL:OBSTRUCTION_AVOID car accidents ] on [SL:PATH [IN:GET_LOCATION [SL:CATEGORY_LOCATION the highway ] ] ] ]
Can you show me a route with less traffic	Can you show me a route with less traffic	[IN:UPDATE_DIRECTIONS Can you show me a route with less [SL:OBSTRUCTION_AVOID traffic ] ]
is there an alternate route i can take with less traffic	is there an alternate route i can take with less traffic	[IN:UPDATE_DIRECTIONS is there an alternate route i can take with less [SL:OBSTRUCTION_AVOID traffic ] ]
Take me on a route with no traffic	Take me on a route with no traffic	[IN:GET_DIRECTIONS Take me on a route with no [SL:OBSTRUCTION_AVOID traffic ] ]
Give me a route from home to work with the least amount of traffic	Give me a route from home to work with the least amount of traffic	[IN:GET_DIRECTIONS Give me a route from [SL:SOURCE [IN:GET_LOCATION_HOME home ] ] to [SL:DESTINATION [IN:GET_LOCATION_WORK work ] ] with the least amount of [SL:OBSTRUCTION_AVOID traffic ] ]
How do I avoid busy traffic today	How do I avoid busy traffic today	[IN:GET_DIRECTIONS How do I avoid busy [SL:OBSTRUCTION_AVOID traffic ] [SL:DATE_TIME_DEPARTURE today ] ]
what detour could i take to avoid the construction on the way to dads house	what detour could i take to avoid the construction on the way to dads house	[IN:GET_DIRECTIONS what [SL:PATH [IN:GET_LOCATION [SL:CATEGORY_LOCATION detour ] ] ] could i take to avoid [SL:OBSTRUCTION_AVOID the construction ] on the way to [SL:DESTINATION [IN:GET_LOCATION_HOME [SL:TYPE_RELATION dads ] house ] ] ]
What is the fastest rout to take to Goochland and to avoid traffic?	What is the fastest rout to take to Goochland and to avoid traffic ?	[IN:GET_DIRECTIONS What is the fastest rout to take to [SL:DESTINATION Goochland ] and to avoid [SL:OBSTRUCTION_AVOID traffic ] ? ]
Is there an alternate route to avoid the traffic on I-15	Is there an alternate route to avoid the traffic on I - 15	[IN:UPDATE_DIRECTIONS Is there an alternate route to avoid [SL:OBSTRUCTION_AVOID the traffic ] on I - 15 ]
Can I get to my uncle's house by 2pm without passing construction?	Can I get to my uncle 's house by 2 pm without passing construction ?	[IN:GET_ESTIMATED_ARRIVAL Can I get to [SL:DESTINATION [IN:GET_LOCATION_HOME [SL:CONTACT_RELATED my ] [SL:TYPE_RELATION uncle ] 's house ] ] [SL:DATE_TIME_ARRIVAL by 2 pm ] without passing [SL:OBSTRUCTION_AVOID construction ] ? ]
Is there a clear route with no traffic	Is there a clear route with no traffic	[IN:GET_DIRECTIONS Is there a clear route with no [SL:OBSTRUCTION_AVOID traffic ] ]
Please point me to where there is not a lot of traffic	Please point me to where there is not a lot of traffic	[IN:GET_DIRECTIONS Please point me to where there is not a lot of [SL:OBSTRUCTION_AVOID traffic ] ]
Which route has the least traffic to Riverbend Hospital	Which route has the least traffic to Riverbend Hospital	[IN:GET_DIRECTIONS Which route has the least [SL:OBSTRUCTION_AVOID traffic ] to [SL:DESTINATION [IN:GET_LOCATION [SL:POINT_ON_MAP Riverbend Hospital ] ] ] ]
Is there a detour to get out of this traffic	Is there a detour to get out of this traffic	[IN:UPDATE_DIRECTIONS Is there a [SL:PATH detour ] to get out of [SL:OBSTRUCTION_AVOID this traffic ] ]
fastest route in order to avoid traffic	fastest route in order to avoid traffic	[IN:GET_DIRECTIONS fastest route in order to avoid [SL:OBSTRUCTION_AVOID traffic ] ]
Can I drive to the ski resort without any traffic congestion if I leave at 7am	Can I drive to the ski resort without any traffic congestion if I leave at 7 am	[IN:GET_DIRECTIONS Can I drive to [SL:DESTINATION [IN:GET_LOCATION [SL:CATEGORY_LOCATION the ski resort ] ] ] without any [SL:OBSTRUCTION_AVOID traffic congestion ] if I leave [SL:DATE_TIME_DEPARTURE at 7 am ] ]
Can I avoid traffic by taking a different bridge	Can I avoid traffic by taking a different bridge	[IN:UPDATE_DIRECTIONS Can I avoid [SL:OBSTRUCTION_AVOID traffic ] by taking a different [SL:PATH [IN:GET_LOCATION [SL:CATEGORY_LOCATION bridge ] ] ] ]
how can i get out of this traffic	how can i get out of this traffic	[IN:UPDATE_DIRECTIONS how can i get out of [SL:OBSTRUCTION_AVOID this traffic ] ]
how do i avoid city traffic	how do i avoid city traffic	[IN:GET_DIRECTIONS how do i avoid city [SL:OBSTRUCTION_AVOID traffic ] ]
Are there any alternate routes to take to work that avoid road construction	Are there any alternate routes to take to work that avoid road construction	[IN:GET_DIRECTIONS Are there any alternate routes to take to [SL:DESTINATION [IN:GET_LOCATION_WORK work ] ] that avoid [SL:OBSTRUCTION_AVOID road construction ] ]
take me where there is to traffic	take me where there is to traffic	[IN:GET_DIRECTIONS take me where there is to [SL:OBSTRUCTION_AVOID traffic ] ]
how can i avoid road work going from seattle to tacoma	how can i avoid road work going from seattle to tacoma	[IN:GET_DIRECTIONS how can i avoid [SL:OBSTRUCTION_AVOID road work ] going from [SL:SOURCE seattle ] to [SL:DESTINATION tacoma ] ]
what is the earliest to drive the I4 without getting in traffic jams	what is the earliest to drive the I4 without getting in traffic jams	[IN:GET_ESTIMATED_DEPARTURE what is the earliest to [SL:METHOD_TRAVEL drive ] [SL:PATH the I4 ] without getting in [SL:OBSTRUCTION_AVOID traffic jams ] ]
Bypass this traffic through a different navigational route	Bypass this traffic through a different navigational route	[IN:UPDATE_DIRECTIONS Bypass [SL:OBSTRUCTION_AVOID this traffic ] through a different navigational route ]
Is there a way around the fire at the concert?	Is there a way around the fire at the concert ?	[IN:GET_DIRECTIONS Is there a way around [SL:OBSTRUCTION_AVOID the fire ] at the concert ? ]
Which route home has the least traffic	Which route home has the least traffic	[IN:GET_DIRECTIONS Which route [SL:DESTINATION [IN:GET_LOCATION_HOME home ] ] has the least [SL:OBSTRUCTION_AVOID traffic ] ]
Give me driving directions to the Closest grocery store to my house that has no construction.	Give me driving directions to the Closest grocery store to my house that has no construction .	[IN:GET_DIRECTIONS Give me [SL:METHOD_TRAVEL driving ] directions to [SL:DESTINATION [IN:GET_LOCATION the [SL:LOCATION_MODIFIER Closest ] [SL:CATEGORY_LOCATION grocery store ] to [SL:LOCATION_MODIFIER [IN:GET_LOCATION_HOME [SL:CONTACT my ] house ] ] ] ] that has no [SL:OBSTRUCTION_AVOID construction ] . ]
What way should I drive home to avoid traffic	What way should I drive home to avoid traffic	[IN:GET_DIRECTIONS What way should I [SL:METHOD_TRAVEL drive ] [SL:DESTINATION [IN:GET_LOCATION_HOME home ] ] to avoid [SL:OBSTRUCTION_AVOID traffic ] ]
How can I avoid traffic tonight	How can I avoid traffic tonight	[IN:GET_DIRECTIONS How can I avoid [SL:OBSTRUCTION_AVOID traffic ] [SL:DATE_TIME_DEPARTURE tonight ] ]
How do I get around the accident	How do I get around the accident	[IN:UPDATE_DIRECTIONS How do I get around [SL:OBSTRUCTION_AVOID the accident ] ]
IS THERE A ROUTE AVAILABLE WITH LESS TRAFFIC	IS THERE A ROUTE AVAILABLE WITH LESS TRAFFIC	[IN:UPDATE_DIRECTIONS IS THERE A ROUTE AVAILABLE WITH LESS [SL:OBSTRUCTION_AVOID TRAFFIC ] ]
Get directions to downtown Cincinatti without passing construction	Get directions to downtown Cincinatti without passing construction	[IN:GET_DIRECTIONS Get directions to [SL:DESTINATION downtown Cincinatti ] without passing [SL:OBSTRUCTION_AVOID construction ] ]
Tell me the time to New Hampshire using only back roads with no construction	Tell me the time to New Hampshire using only back roads with no construction	[IN:GET_ESTIMATED_DURATION Tell me the time to [SL:DESTINATION New Hampshire ] using only [SL:PATH [IN:GET_LOCATION [SL:CATEGORY_LOCATION back roads ] ] ] with no [SL:OBSTRUCTION_AVOID construction ] ]
Can I avoid the traffic around Arrowhead Stadium on the way the St Patrick's Day parade downtown?	Can I avoid the traffic around Arrowhead Stadium on the way the St Patrick 's Day parade downtown ?	[IN:GET_DIRECTIONS Can I avoid [SL:OBSTRUCTION_AVOID the traffic around Arrowhead Stadium ] on the way [SL:DESTINATION [IN:GET_EVENT the [SL:DATE_TIME St Patrick 's Day ] [SL:CATEGORY_EVENT parade ] [SL:LOCATION downtown ] ] ] ? ]
I need to avoid down power lines and construction, how do I get home from my current location?	I need to avoid down power lines and construction , how do I get home from my current location ?	[IN:GET_DIRECTIONS I need to avoid [SL:OBSTRUCTION_AVOID down power lines ] and [SL:OBSTRUCTION_AVOID construction ] , how do I get [SL:DESTINATION [IN:GET_LOCATION_HOME home ] ] from [SL:SOURCE [IN:GET_LOCATION [SL:LOCATION_USER my current location ] ] ] ? ]
are there alternative routes to bypass heavy traffic areas	are there alternative routes to bypass heavy traffic areas	[IN:UPDATE_DIRECTIONS are there alternative routes to bypass heavy [SL:OBSTRUCTION_AVOID traffic ] areas ]
I want to get to the dentist without traffic	I want to get to the dentist without traffic	[IN:GET_DIRECTIONS I want to get to [SL:DESTINATION [IN:GET_LOCATION [SL:CATEGORY_LOCATION the dentist ] ] ] without [SL:OBSTRUCTION_AVOID traffic ] ]
Please give me directions to the concert and avoid all construction	Please give me directions to the concert and avoid all construction	[IN:GET_DIRECTIONS Please give me directions to [SL:DESTINATION [IN:GET_EVENT [SL:CATEGORY_EVENT the concert ] ] ] and avoid all [SL:OBSTRUCTION_AVOID construction ] ]
What's the quickest way to the One Motorcycle Show without hitting the blockades?	What 's the quickest way to the One Motorcycle Show without hitting the blockades ?	[IN:GET_DIRECTIONS What 's the quickest way to [SL:DESTINATION [IN:GET_EVENT [SL:CATEGORY_EVENT the One Motorcycle Show ] ] ] without hitting [SL:OBSTRUCTION_AVOID the blockades ] ? ]
Can I get from 4th Ave & Main St Las Vegas to the Bulls Game without detours?	Can I get from 4th Ave & Main St Las Vegas to the Bulls Game without detours ?	[IN:GET_DIRECTIONS Can I get from [SL:SOURCE [IN:GET_LOCATION [SL:LOCATION 4th Ave ] & [SL:LOCATION Main St ] [SL:LOCATION_MODIFIER Las Vegas ] ] ] to [SL:DESTINATION [IN:GET_EVENT the [SL:NAME_EVENT Bulls ] [SL:CATEGORY_EVENT Game ] ] ] without [SL:OBSTRUCTION_AVOID detours ] ? ]
what time can I make it to Catuaí passing through Londrina downtown without any downed power lines?	what time can I make it to Catuaí passing through Londrina downtown without any downed power lines ?	[IN:GET_ESTIMATED_ARRIVAL what time can I make it to [SL:DESTINATION Catuaí ] passing through [SL:WAYPOINT Londrina downtown ] without any [SL:OBSTRUCTION_AVOID downed power lines ] ? ]
Can you tell me the route with the least traffic delays between here and Shoppingtown mall if I leave right now?	Can you tell me the route with the least traffic delays between here and Shoppingtown mall if I leave right now ?	[IN:GET_DIRECTIONS Can you tell me the route with the least [SL:OBSTRUCTION_AVOID traffic delays ] between [SL:SOURCE [IN:GET_LOCATION [SL:LOCATION_USER here ] ] ] and [SL:DESTINATION [IN:GET_LOCATION [SL:POINT_ON_MAP Shoppingtown mall ] ] ] if I leave [SL:DATE_TIME_DEPARTURE right now ] ? ]
How do I avoid traffic around DC	How do I avoid traffic around DC	[IN:GET_INFO_TRAFFIC How do I avoid [SL:OBSTRUCTION_AVOID traffic ] [SL:LOCATION [IN:GET_LOCATION [SL:SEARCH_RADIUS around ] [SL:LOCATION DC ] ] ] ]
best time to leave to avoid morning traffic on 350 hwy	best time to leave to avoid morning traffic on 350 hwy	[IN:GET_ESTIMATED_DEPARTURE best time to leave to avoid [SL:DATE_TIME_DEPARTURE morning ] [SL:OBSTRUCTION_AVOID traffic ] on [SL:LOCATION 350 hwy ] ]
Can I get to Nanuet to NYC before 6pm without traffic?	Can I get to Nanuet to NYC before 6 pm without traffic ?	[IN:GET_ESTIMATED_ARRIVAL Can I get to [SL:SOURCE Nanuet ] to [SL:DESTINATION NYC ] [SL:DATE_TIME_ARRIVAL before 6 pm ] without [SL:OBSTRUCTION_AVOID traffic ] ? ]
Can you find an alternate route to X around heavy traffic	Can you find an alternate route to X around heavy traffic	[IN:UPDATE_DIRECTIONS Can you find an alternate route to [SL:DESTINATION X ] around heavy [SL:OBSTRUCTION_AVOID traffic ] ]
Leaving right now can I get to Hawthorne by 5:00 pm and avoid delays?	Leaving right now can I get to Hawthorne by 5 : 00 pm and avoid delays ?	[IN:GET_ESTIMATED_ARRIVAL Leaving [SL:DATE_TIME_DEPARTURE right now ] can I get to [SL:DESTINATION Hawthorne ] [SL:DATE_TIME_ARRIVAL by 5 : 00 pm ] and avoid [SL:OBSTRUCTION_AVOID delays ] ? ]
Give me directions with the least amount of traffic	Give me directions with the least amount of traffic	[IN:GET_DIRECTIONS Give me directions with the least amount of [SL:OBSTRUCTION_AVOID traffic ] ]
What route has the least stop and go	What route has the least stop and go	[IN:GET_DIRECTIONS What route has the least [SL:OBSTRUCTION_AVOID stop and go ] ]
what is the best way to get around the wreck on I-10	what is the best way to get around the wreck on I - 10	[IN:GET_DIRECTIONS what is the best way to get around [SL:OBSTRUCTION_AVOID the wreck ] on I - 10 ]
Avoid traffic driving to Jane's house	Avoid traffic driving to Jane 's house	[IN:GET_DIRECTIONS Avoid [SL:OBSTRUCTION_AVOID traffic ] [SL:METHOD_TRAVEL driving ] to [SL:DESTINATION [IN:GET_LOCATION_HOME [SL:CONTACT Jane ] 's house ] ] ]
fast way between west chester and downtown philly without constrction	fast way between west chester and downtown philly without constrction	[IN:GET_DIRECTIONS fast way between [SL:SOURCE west chester ] and [SL:DESTINATION downtown philly ] without [SL:OBSTRUCTION_AVOID constrction ] ]
What route can I take with no traffic	What route can I take with no traffic	[IN:GET_DIRECTIONS What route can I take with no [SL:OBSTRUCTION_AVOID traffic ] ]
which way can i avoid the heaviest traffic to the city	which way can i avoid the heaviest traffic to the city	[IN:GET_DIRECTIONS which way can i avoid the heaviest [SL:OBSTRUCTION_AVOID traffic ] to [SL:DESTINATION [IN:GET_LOCATION [SL:CATEGORY_LOCATION the city ] ] ] ]
how can i avoid construction on I-110  to reach Zodiac Pisces happening in Mountain View tonight.	how can i avoid construction on I - 110 to reach Zodiac Pisces happening in Mountain View tonight .	[IN:GET_DIRECTIONS how can i avoid [SL:OBSTRUCTION_AVOID construction on I - 110 ] to reach [SL:DESTINATION [IN:GET_EVENT [SL:CATEGORY_EVENT Zodiac Pisces ] happening in [SL:LOCATION Mountain View ] [SL:DATE_TIME tonight ] ] ] . ]
Can I go from lorain to vermillion without meeting construction?	Can I go from lorain to vermillion without meeting construction ?	[IN:GET_DIRECTIONS Can I go from [SL:SOURCE lorain ] to [SL:DESTINATION vermillion ] without meeting [SL:OBSTRUCTION_AVOID construction ] ? ]
Passing over crowded seattle street to space needle	Passing over crowded seattle street to space needle	[IN:GET_DIRECTIONS Passing over [SL:OBSTRUCTION_AVOID crowded ] seattle street to [SL:DESTINATION [IN:GET_LOCATION [SL:POINT_ON_MAP space needle ] ] ] ]
Is there a way to go to my daughter's concert without passing any construction?	Is there a way to go to my daughter 's concert without passing any construction ?	[IN:GET_DIRECTIONS Is there a way to go to [SL:DESTINATION [IN:GET_EVENT [SL:ORGANIZER_EVENT [IN:GET_CONTACT [SL:CONTACT_RELATED my ] [SL:TYPE_RELATION daughter ] ] ] 's [SL:CATEGORY_EVENT concert ] ] ] without passing any [SL:OBSTRUCTION_AVOID construction ] ? ]
What's the best route to avoid traffic to NH on Sunday	What 's the best route to avoid traffic to NH on Sunday	[IN:GET_DIRECTIONS What 's the best route to avoid [SL:OBSTRUCTION_AVOID traffic ] to [SL:DESTINATION NH ] [SL:DATE_TIME_DEPARTURE on Sunday ] ]
can I take another route to get out of this traffic	can I take another route to get out of this traffic	[IN:UPDATE_DIRECTIONS can I take another route to get out of [SL:OBSTRUCTION_AVOID this traffic ] ]
What is the quickest route home with the least amount of traffic	What is the quickest route home with the least amount of traffic	[IN:GET_DIRECTIONS What is the quickest route [SL:DESTINATION [IN:GET_LOCATION_HOME home ] ] with the least amount of [SL:OBSTRUCTION_AVOID traffic ] ]
I have a meeting in downtown Denver at 3 PM, when should I leave to get there on time and avoid heavy traffic	I have a meeting in downtown Denver at 3 PM , when should I leave to get there on time and avoid heavy traffic	[IN:GET_ESTIMATED_DEPARTURE I have a [SL:DESTINATION [IN:GET_EVENT [SL:CATEGORY_EVENT meeting ] in [SL:LOCATION downtown Denver ] [SL:DATE_TIME at 3 PM ] ] ] , when should I leave to get there on time and avoid heavy [SL:OBSTRUCTION_AVOID traffic ] ]
I want routes with less traffic	I want routes with less traffic	[IN:UPDATE_DIRECTIONS I want routes with less [SL:OBSTRUCTION_AVOID traffic ] ]
Tell me how to get to work avoiding traffic.	Tell me how to get to work avoiding traffic .	[IN:GET_DIRECTIONS Tell me how to get to [SL:DESTINATION [IN:GET_LOCATION_WORK work ] ] avoiding [SL:OBSTRUCTION_AVOID traffic ] . ]
Find fast route with less traffic	Find fast route with less traffic	[IN:UPDATE_DIRECTIONS Find fast route with less [SL:OBSTRUCTION_AVOID traffic ] ]
Take me to work without using the freeway or going through construction	Take me to work without using the freeway or going through construction	[IN:GET_DIRECTIONS Take me to [SL:DESTINATION [IN:GET_LOCATION_WORK work ] ] without using [SL:PATH_AVOID [IN:GET_LOCATION [SL:CATEGORY_LOCATION the freeway ] ] ] or going through [SL:OBSTRUCTION_AVOID construction ] ]
Can I avoid the construction on rt 287 to get to the Devils game at 6 pm?	Can I avoid the construction on rt 287 to get to the Devils game at 6 pm ?	[IN:GET_DIRECTIONS Can I avoid [SL:OBSTRUCTION_AVOID the construction ] on rt 287 to get to [SL:DESTINATION [IN:GET_EVENT the [SL:NAME_EVENT Devils ] [SL:CATEGORY_EVENT game ] [SL:DATE_TIME at 6 pm ] ] ] ? ]
fastest route to avoid traffic downtown	fastest route to avoid traffic downtown	[IN:GET_DIRECTIONS fastest route to avoid [SL:OBSTRUCTION_AVOID traffic ] [SL:DESTINATION downtown ] ]
Create the optimal route to avoid the traffic	Create the optimal route to avoid the traffic	[IN:GET_DIRECTIONS Create the optimal route to avoid [SL:OBSTRUCTION_AVOID the traffic ] ]
I WANT TO BE HOME BEFORE 2 P.M WITH NO TRAFFFIC	I WANT TO BE HOME BEFORE 2 P.M WITH NO TRAFFFIC	[IN:GET_DIRECTIONS I WANT TO BE [SL:DESTINATION [IN:GET_LOCATION_HOME HOME ] ] [SL:DATE_TIME_ARRIVAL BEFORE 2 P.M ] WITH NO [SL:OBSTRUCTION_AVOID TRAFFFIC ] ]
Get directions to downtown Houma without passing construction	Get directions to downtown Houma without passing construction	[IN:GET_DIRECTIONS Get directions to [SL:DESTINATION downtown Houma ] without passing [SL:OBSTRUCTION_AVOID construction ] ]
What road will keep me clear of heavy traffic going to Shallowater	What road will keep me clear of heavy traffic going to Shallowater	[IN:GET_DIRECTIONS What road will keep me clear of heavy [SL:OBSTRUCTION_AVOID traffic ] going to [SL:DESTINATION Shallowater ] ]
Where is the best place to drive to get to the airport to avoid traffic	Where is the best place to drive to get to the airport to avoid traffic	[IN:GET_DIRECTIONS Where is the best place to [SL:METHOD_TRAVEL drive ] to get to [SL:DESTINATION [IN:GET_LOCATION [SL:CATEGORY_LOCATION the airport ] ] ] to avoid [SL:OBSTRUCTION_AVOID traffic ] ]
can you tell me other way to avoid the traffic	can you tell me other way to avoid the traffic	[IN:UPDATE_DIRECTIONS can you tell me other way to avoid [SL:OBSTRUCTION_AVOID the traffic ] ]
What is the best rout to avoid traffic going to Snohomish	What is the best rout to avoid traffic going to Snohomish	[IN:GET_DIRECTIONS What is the best rout to avoid [SL:OBSTRUCTION_AVOID traffic ] going to [SL:DESTINATION Snohomish ] ]
Is there a way to get from 2nd Street & Spring Street Chicago to the Jazz festival without delays?	Is there a way to get from 2nd Street & Spring Street Chicago to the Jazz festival without delays ?	[IN:GET_DIRECTIONS Is there a way to get from [SL:SOURCE [IN:GET_LOCATION [SL:LOCATION 2nd Street ] & [SL:LOCATION Spring Street ] [SL:LOCATION_MODIFIER Chicago ] ] ] to [SL:DESTINATION [IN:GET_EVENT [SL:CATEGORY_EVENT the Jazz festival ] ] ] without [SL:OBSTRUCTION_AVOID delays ] ? ]
Can I get to the farmer's market avoiding construction by taking I-90	Can I get to the farmer 's market avoiding construction by taking I - 90	[IN:GET_DIRECTIONS Can I get to [SL:DESTINATION [IN:GET_EVENT [SL:CATEGORY_EVENT the farmer 's market ] ] ] avoiding [SL:OBSTRUCTION_AVOID construction ] by taking [SL:PATH I - 90 ] ]
Is there a way to get from 3rd Ave & Main St Seattle to the Future concert without construction?	Is there a way to get from 3rd Ave & Main St Seattle to the Future concert without construction ?	[IN:GET_DIRECTIONS Is there a way to get from [SL:SOURCE [IN:GET_LOCATION [SL:LOCATION 3rd Ave ] & [SL:LOCATION Main St ] [SL:LOCATION_MODIFIER Seattle ] ] ] to [SL:DESTINATION [IN:GET_EVENT the [SL:NAME_EVENT Future ] [SL:CATEGORY_EVENT concert ] ] ] without [SL:OBSTRUCTION_AVOID construction ] ? ]
give me the shortest route to home without traffic	give me the shortest route to home without traffic	[IN:GET_DIRECTIONS give me the shortest route to [SL:DESTINATION [IN:GET_LOCATION_HOME home ] ] without [SL:OBSTRUCTION_AVOID traffic ] ]
How can I avoid construction on my way to Ann Arbor	How can I avoid construction on my way to Ann Arbor	[IN:GET_DIRECTIONS How can I avoid [SL:OBSTRUCTION_AVOID construction ] on my way to [SL:DESTINATION Ann Arbor ] ]
Get me directions to the Atlanta airport with out construction.	Get me directions to the Atlanta airport with out construction .	[IN:GET_DIRECTIONS Get me directions to [SL:DESTINATION [IN:GET_LOCATION [SL:POINT_ON_MAP the Atlanta airport ] ] ] with out [SL:OBSTRUCTION_AVOID construction ] . ]
How can I avoid traffic going to Costco in Brooklyn on Saturday mornings	How can I avoid traffic going to Costco in Brooklyn on Saturday mornings	[IN:GET_DIRECTIONS How can I avoid [SL:OBSTRUCTION_AVOID traffic ] going to [SL:DESTINATION [IN:GET_LOCATION [SL:POINT_ON_MAP Costco ] in [SL:LOCATION_MODIFIER Brooklyn ] ] ] [SL:DATE_TIME_DEPARTURE on Saturday mornings ] ]
Are there any alternate routes to avoid traffic jams today	Are there any alternate routes to avoid traffic jams today	[IN:UPDATE_DIRECTIONS Are there any alternate routes to avoid [SL:OBSTRUCTION_AVOID traffic jams ] [SL:DATE_TIME_DEPARTURE today ] ]
Is there a way to get from Kalibata street to the Korean food festival in University of Indonesa without traffic congestion?	Is there a way to get from Kalibata street to the Korean food festival in University of Indonesa without traffic congestion ?	[IN:GET_DIRECTIONS Is there a way to get from [SL:SOURCE Kalibata street ] to [SL:DESTINATION [IN:GET_EVENT [SL:CATEGORY_EVENT the Korean food festival ] in [SL:LOCATION [IN:GET_LOCATION [SL:POINT_ON_MAP University of Indonesa ] ] ] ] ] without [SL:OBSTRUCTION_AVOID traffic congestion ] ? ]
is there a way around this traffic	is there a way around this traffic	[IN:UPDATE_DIRECTIONS is there a way around [SL:OBSTRUCTION_AVOID this traffic ] ]
Get the driving time from my mom's to Orlando avoiding constructions	Get the driving time from my mom 's to Orlando avoiding constructions	[IN:GET_ESTIMATED_DURATION Get the [SL:METHOD_TRAVEL driving ] time from [SL:SOURCE [IN:GET_LOCATION_HOME [SL:CONTACT_RELATED my ] [SL:TYPE_RELATION mom ] ] ] 's to [SL:DESTINATION Orlando ] avoiding [SL:OBSTRUCTION_AVOID constructions ] ]
What is the best way to get to the Palladium from North Hollywood avoiding traffic?	What is the best way to get to the Palladium from North Hollywood avoiding traffic ?	[IN:GET_DIRECTIONS What is the best way to get to [SL:DESTINATION [IN:GET_LOCATION [SL:POINT_ON_MAP the Palladium ] ] ] from [SL:SOURCE North Hollywood ] avoiding [SL:OBSTRUCTION_AVOID traffic ] ? ]
Get directions to the zoo without hitting road constructions so that I get there by 11 AM.	Get directions to the zoo without hitting road constructions so that I get there by 11 AM .	[IN:GET_DIRECTIONS Get directions to [SL:DESTINATION [IN:GET_LOCATION [SL:CATEGORY_LOCATION the zoo ] ] ] without hitting [SL:OBSTRUCTION_AVOID road constructions ] so that I get there [SL:DATE_TIME_ARRIVAL by 11 AM ] . ]
how long to drive to virginia beach without detours if i leave by 9am	how long to drive to virginia beach without detours if i leave by 9 am	[IN:GET_ESTIMATED_DURATION how long to [SL:METHOD_TRAVEL drive ] to [SL:DESTINATION virginia beach ] without [SL:OBSTRUCTION_AVOID detours ] if i leave [SL:DATE_TIME_DEPARTURE by 9 am ] ]
I'm going to the Bruins game tonight and need a route around all of the construction downtown.	I'm going to the Bruins game tonight and need a route around all of the construction downtown .	[IN:GET_DIRECTIONS I'm going to [SL:DESTINATION [IN:GET_EVENT the [SL:NAME_EVENT Bruins ] [SL:CATEGORY_EVENT game ] [SL:DATE_TIME tonight ] ] ] and need a route around all of [SL:OBSTRUCTION_AVOID the construction downtown ] . ]
When should I leave to beat traffic on the 60?	When should I leave to beat traffic on the 60 ?	[IN:GET_ESTIMATED_DEPARTURE When should I leave to beat [SL:OBSTRUCTION_AVOID traffic ] on [SL:PATH the 60 ] ? ]
Do you have directions that can bypass the truck traffic and get me to Cook campus by 1 PM?	Do you have directions that can bypass the truck traffic and get me to Cook campus by 1 PM ?	[IN:GET_DIRECTIONS Do you have directions that can bypass [SL:OBSTRUCTION_AVOID the truck traffic ] and get me to [SL:DESTINATION [IN:GET_LOCATION [SL:POINT_ON_MAP Cook campus ] ] ] [SL:DATE_TIME_ARRIVAL by 1 PM ] ? ]
How long is the drive between my house and Lew's house if I avoid the construction on Rugby Road?	How long is the drive between my house and Lew 's house if I avoid the construction on Rugby Road ?	[IN:GET_ESTIMATED_DURATION How long is the [SL:METHOD_TRAVEL drive ] between [SL:SOURCE [IN:GET_LOCATION_HOME [SL:CONTACT my ] house ] ] and [SL:DESTINATION [IN:GET_LOCATION_HOME [SL:CONTACT Lew ] 's house ] ] if I avoid [SL:OBSTRUCTION_AVOID the construction ] on Rugby Road ? ]
is there a faster path around this traffic	is there a faster path around this traffic	[IN:UPDATE_DIRECTIONS is there a faster path around [SL:OBSTRUCTION_AVOID this traffic ] ]
Is there another route that I can go to avoid the traffic accident	Is there another route that I can go to avoid the traffic accident	[IN:UPDATE_DIRECTIONS Is there another route that I can go to avoid [SL:OBSTRUCTION_AVOID the traffic accident ] ]
whats the best way to avoid the traffic near the antique show this weekend leaving from my house to go to moms?	whats the best way to avoid the traffic near the antique show this weekend leaving from my house to go to moms ?	[IN:GET_DIRECTIONS whats the best way to avoid [SL:OBSTRUCTION_AVOID the traffic near the antique show this weekend ] leaving from [SL:SOURCE [IN:GET_LOCATION_HOME [SL:CONTACT my ] house ] ] to go to [SL:DESTINATION [IN:GET_LOCATION_HOME [SL:TYPE_RELATION moms ] ] ] ? ]
If I leave at 4:30pm, will I avoid the traffic toward Westchester?	If I leave at 4 : 30 pm , will I avoid the traffic toward Westchester ?	[IN:GET_INFO_TRAFFIC If I leave [SL:DATE_TIME at 4 : 30 pm ] , will I avoid [SL:OBSTRUCTION_AVOID the traffic ] toward [SL:DESTINATION Westchester ] ? ]
Is there a way to get from Maxwell and Laurel to the Pearl District Festival without construction	Is there a way to get from Maxwell and Laurel to the Pearl District Festival without construction	[IN:GET_DIRECTIONS Is there a way to get from [SL:SOURCE [IN:GET_LOCATION [SL:LOCATION Maxwell ] and [SL:LOCATION Laurel ] ] ] to [SL:DESTINATION [IN:GET_EVENT [SL:CATEGORY_EVENT the Pearl District Festival ] ] ] without [SL:OBSTRUCTION_AVOID construction ] ]
get directions to Arroyo Grande with no heavy traffic if I leave at 3am from home	get directions to Arroyo Grande with no heavy traffic if I leave at 3 am from home	[IN:GET_DIRECTIONS get directions to [SL:DESTINATION Arroyo Grande ] with no heavy [SL:OBSTRUCTION_AVOID traffic ] if I leave [SL:DATE_TIME_DEPARTURE at 3 am ] from [SL:SOURCE [IN:GET_LOCATION_HOME home ] ] ]
What's the best traffic route going to DisneyWorld	What 's the best traffic route going to DisneyWorld	[IN:GET_DIRECTIONS What 's the best [SL:OBSTRUCTION_AVOID traffic ] route going to [SL:DESTINATION [IN:GET_LOCATION [SL:POINT_ON_MAP DisneyWorld ] ] ] ]
Which road home should I take to avoid any traffic delays?	Which road home should I take to avoid any traffic delays ?	[IN:GET_DIRECTIONS Which road [SL:DESTINATION [IN:GET_LOCATION_HOME home ] ] should I take to avoid any [SL:OBSTRUCTION_AVOID traffic delays ] ? ]
When should I leave Lake Tahoe to miss any traffic today?	When should I leave Lake Tahoe to miss any traffic today ?	[IN:GET_ESTIMATED_DEPARTURE When should I leave [SL:SOURCE [IN:GET_LOCATION [SL:POINT_ON_MAP Lake Tahoe ] ] ] to miss any [SL:OBSTRUCTION_AVOID traffic ] [SL:DATE_TIME_DEPARTURE today ] ? ]
Find the shortest distance route from Mimi's house to Tarrant County Courthouse with no construction	Find the shortest distance route from Mimi 's house to Tarrant County Courthouse with no construction	[IN:GET_DIRECTIONS Find the shortest distance route from [SL:SOURCE [IN:GET_LOCATION_HOME [SL:CONTACT Mimi ] 's house ] ] to [SL:DESTINATION [IN:GET_LOCATION [SL:POINT_ON_MAP Tarrant County Courthouse ] ] ] with no [SL:OBSTRUCTION_AVOID construction ] ]
What's the route to Virginia Beach with the least traffic	What 's the route to Virginia Beach with the least traffic	[IN:GET_DIRECTIONS What 's the route to [SL:DESTINATION Virginia Beach ] with the least [SL:OBSTRUCTION_AVOID traffic ] ]
There's a downed power line on South Willow, are there any side streets that will lead me to the Verizon Center by 7pm?	There 's a downed power line on South Willow , are there any side streets that will lead me to the Verizon Center by 7 pm ?	[IN:GET_DIRECTIONS There 's a [SL:OBSTRUCTION_AVOID downed power line ] on South Willow , are there any [SL:PATH [IN:GET_LOCATION [SL:CATEGORY_LOCATION side streets ] ] ] that will lead me to [SL:DESTINATION [IN:GET_LOCATION [SL:POINT_ON_MAP the Verizon Center ] ] ] [SL:DATE_TIME_ARRIVAL by 7 pm ] ? ]
Find the fastest route around this traffic using shortest distance to Bolivar Rd in Denton	Find the fastest route around this traffic using shortest distance to Bolivar Rd in Denton	[IN:GET_DIRECTIONS Find the fastest route around [SL:OBSTRUCTION_AVOID this traffic ] using shortest distance to [SL:DESTINATION [IN:GET_LOCATION [SL:LOCATION Bolivar Rd ] in [SL:LOCATION_MODIFIER Denton ] ] ] ]
What is the best route to get to First Friday to avoid traffic, if I leave at 6:00pm	What is the best route to get to First Friday to avoid traffic , if I leave at 6 : 00 pm	[IN:GET_DIRECTIONS What is the best route to get to [SL:DESTINATION [IN:GET_EVENT [SL:CATEGORY_EVENT First Friday ] ] ] to avoid [SL:OBSTRUCTION_AVOID traffic ] , if I leave [SL:DATE_TIME_DEPARTURE at 6 : 00 pm ] ]
What is the best way to avoid traffic if I leave from my current location and go do Kathy's house in Portland on 25th st?	What is the best way to avoid traffic if I leave from my current location and go do Kathy 's house in Portland on 25th st ?	[IN:GET_DIRECTIONS What is the best way to avoid [SL:OBSTRUCTION_AVOID traffic ] if I leave from [SL:SOURCE [IN:GET_LOCATION [SL:LOCATION_USER my current location ] ] ] and go do [SL:DESTINATION [IN:GET_LOCATION_HOME [SL:CONTACT Kathy ] 's house in [SL:LOCATION [IN:GET_LOCATION [SL:LOCATION_MODIFIER Portland ] ] ] on [SL:LOCATION [IN:GET_LOCATION [SL:LOCATION_MODIFIER 25th st ] ] ] ] ] ? ]
Which route would be best to avoid traffic	Which route would be best to avoid traffic	[IN:GET_DIRECTIONS Which route would be best to avoid [SL:OBSTRUCTION_AVOID traffic ] ]
give me a route home with no accidents	give me a route home with no accidents	[IN:GET_DIRECTIONS give me a route [SL:DESTINATION [IN:GET_LOCATION_HOME home ] ] with no [SL:OBSTRUCTION_AVOID accidents ] ]
What's the quickest route avoiding traffic for driving to Miami	What 's the quickest route avoiding traffic for driving to Miami	[IN:GET_DIRECTIONS What 's the quickest route avoiding [SL:OBSTRUCTION_AVOID traffic ] for [SL:METHOD_TRAVEL driving ] to [SL:DESTINATION Miami ] ]
Get directions to downtown New Iberia without passing construction	Get directions to downtown New Iberia without passing construction	[IN:GET_DIRECTIONS Get directions to [SL:DESTINATION downtown New Iberia ] without passing [SL:OBSTRUCTION_AVOID construction ] ]
what route should I take to work to avoid traffic	what route should I take to work to avoid traffic	[IN:GET_DIRECTIONS what route should I take to [SL:DESTINATION [IN:GET_LOCATION_WORK work ] ] to avoid [SL:OBSTRUCTION_AVOID traffic ] ]
Best route to beat the traffic	Best route to beat the traffic	[IN:GET_DIRECTIONS Best route to beat [SL:OBSTRUCTION_AVOID the traffic ] ]
Can I avoid any traffic	Can I avoid any traffic	[IN:GET_DIRECTIONS Can I avoid any [SL:OBSTRUCTION_AVOID traffic ] ]
How long will it take to get to dad's house without running into traffic from the christmas parade?	How long will it take to get to dad 's house without running into traffic from the christmas parade ?	[IN:GET_ESTIMATED_DURATION How long will it take to get to [SL:DESTINATION [IN:GET_LOCATION_HOME [SL:TYPE_RELATION dad ] 's house ] ] without running into [SL:OBSTRUCTION_AVOID traffic from the christmas parade ] ? ]
Plot driving I84 to Hartford with least amount of traffic arriving by 1pm.	Plot driving I84 to Hartford with least amount of traffic arriving by 1 pm .	[IN:GET_DIRECTIONS Plot [SL:METHOD_TRAVEL driving ] [SL:PATH I84 ] to [SL:DESTINATION Hartford ] with least amount of [SL:OBSTRUCTION_AVOID traffic ] arriving [SL:DATE_TIME_ARRIVAL by 1 pm ] . ]
any accidents to avoid	any accidents to avoid	[IN:GET_INFO_TRAFFIC any [SL:OBSTRUCTION_AVOID accidents ] to avoid ]
How do I get out of this traffic	How do I get out of this traffic	[IN:GET_DIRECTIONS How do I get out of [SL:OBSTRUCTION_AVOID this traffic ] ]
whats the best way to avoid the traffic	whats the best way to avoid the traffic	[IN:GET_DIRECTIONS whats the best way to avoid [SL:OBSTRUCTION_AVOID the traffic ] ]
what route options do I have to avoid downtown construction and make it to football game on eastside by 4pm	what route options do I have to avoid downtown construction and make it to football game on eastside by 4 pm	[IN:GET_DIRECTIONS what route options do I have to avoid downtown [SL:OBSTRUCTION_AVOID construction ] and make it to [SL:DESTINATION [IN:GET_EVENT [SL:CATEGORY_EVENT football game ] on [SL:LOCATION eastside ] ] ] [SL:DATE_TIME_ARRIVAL by 4 pm ] ]
I need to find a way to get to the hospital without running into traffic	I need to find a way to get to the hospital without running into traffic	[IN:GET_DIRECTIONS I need to find a way to get to [SL:DESTINATION [IN:GET_LOCATION [SL:CATEGORY_LOCATION the hospital ] ] ] without running into [SL:OBSTRUCTION_AVOID traffic ] ]
Get directions to Destiny that comes through the village of Liverpool and has no construction.	Get directions to Destiny that comes through the village of Liverpool and has no construction .	[IN:GET_DIRECTIONS Get directions to [SL:DESTINATION Destiny ] that comes through the village of [SL:WAYPOINT Liverpool ] and has no [SL:OBSTRUCTION_AVOID construction ] . ]
Is there an alternative route to avoid traffic	Is there an alternative route to avoid traffic	[IN:UPDATE_DIRECTIONS Is there an alternative route to avoid [SL:OBSTRUCTION_AVOID traffic ] ]
Give me a detour to avoid the traffic backup on 85N right now	Give me a detour to avoid the traffic backup on 85N right now	[IN:UPDATE_DIRECTIONS Give me a detour to avoid [SL:OBSTRUCTION_AVOID the traffic backup ] on [SL:PATH_AVOID 85N ] [SL:DATE_TIME_DEPARTURE right now ] ]
How much time will it take to get downtown if I detour around the construction near Leon Springs?	How much time will it take to get downtown if I detour around the construction near Leon Springs ?	[IN:GET_ESTIMATED_DURATION How much time will it take to get [SL:DESTINATION downtown ] if I detour around [SL:OBSTRUCTION_AVOID the construction ] near Leon Springs ? ]
where is the least amount of traffic	where is the least amount of traffic	[IN:GET_INFO_TRAFFIC where is the least amount of [SL:OBSTRUCTION_AVOID traffic ] ]
The home and builder show is in Novi what's the least congested route to get there if I leave at 5 PM	The home and builder show is in Novi what 's the least congested route to get there if I leave at 5 PM	[IN:GET_DIRECTIONS [SL:DESTINATION [IN:GET_EVENT [SL:CATEGORY_EVENT The home and builder show ] is in [SL:LOCATION Novi ] ] ] what 's the least [SL:OBSTRUCTION_AVOID congested ] route to get there if I leave [SL:DATE_TIME_DEPARTURE at 5 PM ] ]
What is my best route home to avoid traffic	What is my best route home to avoid traffic	[IN:GET_DIRECTIONS What is my best route [SL:DESTINATION [IN:GET_LOCATION_HOME home ] ] to avoid [SL:OBSTRUCTION_AVOID traffic ] ]
Can you reroute me around this traffic	Can you reroute me around this traffic	[IN:UPDATE_DIRECTIONS Can you reroute me around [SL:OBSTRUCTION_AVOID this traffic ] ]
Suggestions to avoid traffic	Suggestions to avoid traffic	[IN:UPDATE_DIRECTIONS Suggestions to avoid [SL:OBSTRUCTION_AVOID traffic ] ]
how long it take without heavy traffic	how long it take without heavy traffic	[IN:GET_ESTIMATED_DURATION how long it take without heavy [SL:OBSTRUCTION_AVOID traffic ] ]
what's the best route without traffic	what 's the best route without traffic	[IN:GET_DIRECTIONS what 's the best route without [SL:OBSTRUCTION_AVOID traffic ] ]
if there is an accident what is an alternative route	if there is an accident what is an alternative route	[IN:UPDATE_DIRECTIONS if there is an [SL:OBSTRUCTION_AVOID accident ] what is an alternative route ]
IS THERE AN ALTERNATE ROUTE SO I CAN AVOID THIS TRAFFIC	IS THERE AN ALTERNATE ROUTE SO I CAN AVOID THIS TRAFFIC	[IN:UPDATE_DIRECTIONS IS THERE AN ALTERNATE ROUTE SO I CAN AVOID [SL:OBSTRUCTION_AVOID THIS TRAFFIC ] ]
Tell me how to get from my house to Wilderwood Service Dogs, avoiding road closures from ice.	Tell me how to get from my house to Wilderwood Service Dogs , avoiding road closures from ice .	[IN:GET_DIRECTIONS Tell me how to get from [SL:SOURCE [IN:GET_LOCATION_HOME [SL:CONTACT my ] house ] ] to [SL:DESTINATION [IN:GET_LOCATION [SL:POINT_ON_MAP Wilderwood Service Dogs ] ] ] , avoiding [SL:OBSTRUCTION_AVOID road closures ] from [SL:ROAD_CONDITION_AVOID ice ] . ]
what is the fastest way to get from my house to my office while bypassing any major delays?	what is the fastest way to get from my house to my office while bypassing any major delays ?	[IN:GET_DIRECTIONS what is the fastest way to get from [SL:SOURCE [IN:GET_LOCATION_HOME [SL:CONTACT my ] house ] ] to [SL:DESTINATION [IN:GET_LOCATION_WORK [SL:CONTACT my ] office ] ] while bypassing any major [SL:OBSTRUCTION_AVOID delays ] ? ]
Give me the route to school with the least traffic	Give me the route to school with the least traffic	[IN:GET_DIRECTIONS Give me the route to [SL:DESTINATION [IN:GET_LOCATION_SCHOOL school ] ] with the least [SL:OBSTRUCTION_AVOID traffic ] ]
what is the best route to avoid this accident	what is the best route to avoid this accident	[IN:GET_DIRECTIONS what is the best route to avoid [SL:OBSTRUCTION_AVOID this accident ] ]
what exit should i take to go around the accident	what exit should i take to go around the accident	[IN:GET_DIRECTIONS what exit should i take to go around [SL:OBSTRUCTION_AVOID the accident ] ]
What's the route with the lightest traffic	What 's the route with the lightest traffic	[IN:GET_DIRECTIONS What 's the route with the lightest [SL:OBSTRUCTION_AVOID traffic ] ]
Is there a way to get around the construction on St. Rd 49 so I can get to my sister's house by 1 pm?	Is there a way to get around the construction on St . Rd 49 so I can get to my sister 's house by 1 pm ?	[IN:GET_DIRECTIONS Is there a way to get around [SL:OBSTRUCTION_AVOID the construction on St . Rd 49 ] so I can get to [SL:DESTINATION [IN:GET_LOCATION_HOME [SL:CONTACT_RELATED my ] [SL:TYPE_RELATION sister ] 's house ] ] [SL:DATE_TIME_ARRIVAL by 1 pm ] ? ]
Is there a way around the accident	Is there a way around the accident	[IN:GET_DIRECTIONS Is there a way around [SL:OBSTRUCTION_AVOID the accident ] ]
Can you give me a route to avoid traffic	Can you give me a route to avoid traffic	[IN:GET_DIRECTIONS Can you give me a route to avoid [SL:OBSTRUCTION_AVOID traffic ] ]
If I want to make the Red Sox game in Boston, what time should I leave Harvard to avoid traffic?	If I want to make the Red Sox game in Boston , what time should I leave Harvard to avoid traffic ?	[IN:GET_ESTIMATED_DEPARTURE If I want to make [SL:DESTINATION [IN:GET_EVENT the [SL:NAME_EVENT Red Sox ] [SL:CATEGORY_EVENT game ] in [SL:LOCATION Boston ] ] ] , what time should I leave [SL:SOURCE [IN:GET_LOCATION [SL:POINT_ON_MAP Harvard ] ] ] to avoid [SL:OBSTRUCTION_AVOID traffic ] ? ]
how long is the drive from  Seattle to Vancouver without traffic	how long is the drive from Seattle to Vancouver without traffic	[IN:GET_ESTIMATED_DURATION how long is the [SL:METHOD_TRAVEL drive ] from [SL:SOURCE Seattle ] to [SL:DESTINATION Vancouver ] without [SL:OBSTRUCTION_AVOID traffic ] ]
Any route without heavy traffic alert from  Joseph's house to the airport	Any route without heavy traffic alert from Joseph 's house to the airport	[IN:GET_DIRECTIONS Any route without [SL:OBSTRUCTION_AVOID heavy traffic ] alert from [SL:SOURCE [IN:GET_LOCATION_HOME [SL:CONTACT Joseph ] 's house ] ] to [SL:DESTINATION [IN:GET_LOCATION [SL:CATEGORY_LOCATION the airport ] ] ] ]
show me how to get around the construction on post st	show me how to get around the construction on post st	[IN:GET_DIRECTIONS show me how to get around [SL:OBSTRUCTION_AVOID the construction ] on [SL:PATH post st ] ]
Reroute to avoid traffic	Reroute to avoid traffic	[IN:UPDATE_DIRECTIONS Reroute to avoid [SL:OBSTRUCTION_AVOID traffic ] ]
Which way should I take home that has the least amount of traffic	Which way should I take home that has the least amount of traffic	[IN:GET_DIRECTIONS Which way should I take [SL:DESTINATION [IN:GET_LOCATION_HOME home ] ] that has the least amount of [SL:OBSTRUCTION_AVOID traffic ] ]
Any way to avoid this traffic	Any way to avoid this traffic	[IN:UPDATE_DIRECTIONS Any way to avoid [SL:OBSTRUCTION_AVOID this traffic ] ]
How long will it take me to get to work, taking the freeway mostly, but avoiding the crash?	How long will it take me to get to work , taking the freeway mostly , but avoiding the crash ?	[IN:GET_ESTIMATED_DURATION How long will it take me to get to [SL:DESTINATION [IN:GET_LOCATION_WORK work ] ] , taking [SL:PATH [IN:GET_LOCATION [SL:CATEGORY_LOCATION the freeway ] ] ] mostly , but avoiding [SL:OBSTRUCTION_AVOID the crash ] ? ]
what time should i leave to beat traffic	what time should i leave to beat traffic	[IN:GET_ESTIMATED_DEPARTURE what time should i leave to beat [SL:OBSTRUCTION_AVOID traffic ] ]
Re-route me away from the traffic jam	Re - route me away from the traffic jam	[IN:UPDATE_DIRECTIONS Re - route me away from [SL:OBSTRUCTION_AVOID the traffic jam ] ]
Can you tell me directions from home to the airport without traffic, arriving at 4pm	Can you tell me directions from home to the airport without traffic , arriving at 4 pm	[IN:GET_DIRECTIONS Can you tell me directions from [SL:SOURCE [IN:GET_LOCATION_HOME home ] ] to [SL:DESTINATION [IN:GET_LOCATION [SL:CATEGORY_LOCATION the airport ] ] ] without [SL:OBSTRUCTION_AVOID traffic ] , arriving [SL:DATE_TIME_ARRIVAL at 4 pm ] ]
directions to target in McDounough avoiding highways and construction	directions to target in McDounough avoiding highways and construction	[IN:GET_DIRECTIONS directions to [SL:DESTINATION [IN:GET_LOCATION [SL:POINT_ON_MAP target ] in [SL:LOCATION_MODIFIER McDounough ] ] ] avoiding [SL:PATH_AVOID highways ] and [SL:OBSTRUCTION_AVOID construction ] ]
Can I get to broad street in Philadelphia right now without any traffic?	Can I get to broad street in Philadelphia right now without any traffic ?	[IN:GET_DIRECTIONS Can I get to [SL:DESTINATION [IN:GET_LOCATION [SL:LOCATION broad street ] in [SL:LOCATION_MODIFIER Philadelphia ] ] ] [SL:DATE_TIME_DEPARTURE right now ] without any [SL:OBSTRUCTION_AVOID traffic ] ? ]
When is the best time for I-80 westbound commute for the least traffic congestion	When is the best time for I - 80 westbound commute for the least traffic congestion	[IN:GET_ESTIMATED_DEPARTURE When is the best time for [SL:PATH I - 80 westbound commute ] for the least [SL:OBSTRUCTION_AVOID traffic congestion ] ]
When should I leave to avoid traffic	When should I leave to avoid traffic	[IN:GET_ESTIMATED_DEPARTURE When should I leave to avoid [SL:OBSTRUCTION_AVOID traffic ] ]
I-15 always has traffic are there any alternative routes to my moms house?	I - 15 always has traffic are there any alternative routes to my moms house ?	[IN:GET_DIRECTIONS [SL:PATH_AVOID I - 15 ] always has [SL:OBSTRUCTION_AVOID traffic ] are there any alternative routes to [SL:DESTINATION [IN:GET_LOCATION_HOME [SL:CONTACT_RELATED my ] [SL:TYPE_RELATION moms ] house ] ] ? ]
calculate a route to downtown LA that avoids traffic	calculate a route to downtown LA that avoids traffic	[IN:GET_DIRECTIONS calculate a route to [SL:DESTINATION downtown LA ] that avoids [SL:OBSTRUCTION_AVOID traffic ] ]
Is there another route around traffic	Is there another route around traffic	[IN:UPDATE_DIRECTIONS Is there another route around [SL:OBSTRUCTION_AVOID traffic ] ]
What time should I leave work to avoid extra traffic on Parkland Ave and Washer due to construction in order to make it to the Radiohead concert by 8 PM?	What time should I leave work to avoid extra traffic on Parkland Ave and Washer due to construction in order to make it to the Radiohead concert by 8 PM ?	[IN:GET_ESTIMATED_DEPARTURE What time should I leave [SL:SOURCE [IN:GET_LOCATION_WORK work ] ] to avoid [SL:OBSTRUCTION_AVOID extra traffic ] on [SL:PATH Parkland Ave ] and [SL:PATH Washer ] due to [SL:OBSTRUCTION_AVOID construction ] in order to make it to [SL:DESTINATION [IN:GET_EVENT the [SL:NAME_EVENT Radiohead ] [SL:CATEGORY_EVENT concert ] ] ] [SL:DATE_TIME_ARRIVAL by 8 PM ] ? ]
What is the best route to take to avoid traffic	What is the best route to take to avoid traffic	[IN:GET_DIRECTIONS What is the best route to take to avoid [SL:OBSTRUCTION_AVOID traffic ] ]
Are there detours around this traffic	Are there detours around this traffic	[IN:UPDATE_DIRECTIONS Are there detours around [SL:OBSTRUCTION_AVOID this traffic ] ]
Is there any way to go a different route to avoid traffic	Is there any way to go a different route to avoid traffic	[IN:GET_DIRECTIONS Is there any way to go a different route to avoid [SL:OBSTRUCTION_AVOID traffic ] ]
Show me how to avoid the Traffic on my Drive to work	Show me how to avoid the Traffic on my Drive to work	[IN:GET_DIRECTIONS Show me how to avoid [SL:OBSTRUCTION_AVOID the Traffic ] on my [SL:METHOD_TRAVEL Drive ] to [SL:DESTINATION [IN:GET_LOCATION_WORK work ] ] ]
Are there any accidents to avoid this morning	Are there any accidents to avoid this morning	[IN:GET_INFO_TRAFFIC Are there any [SL:OBSTRUCTION_AVOID accidents ] to avoid [SL:DATE_TIME this morning ] ]
Best route to avoid traffic between Albuquerque and Santa Fe	Best route to avoid traffic between Albuquerque and Santa Fe	[IN:GET_DIRECTIONS Best route to avoid [SL:OBSTRUCTION_AVOID traffic ] between [SL:SOURCE Albuquerque ] and [SL:DESTINATION Santa Fe ] ]
How do I drive to Diamond Head with the least travel time and traffic	How do I drive to Diamond Head with the least travel time and traffic	[IN:GET_DIRECTIONS How do I [SL:METHOD_TRAVEL drive ] to [SL:DESTINATION [IN:GET_LOCATION [SL:POINT_ON_MAP Diamond Head ] ] ] with the least travel time and [SL:OBSTRUCTION_AVOID traffic ] ]
Shortest distance from pensacola to baton rouge avoiding traffic	Shortest distance from pensacola to baton rouge avoiding traffic	[IN:GET_DISTANCE Shortest distance from [SL:SOURCE pensacola ] to [SL:DESTINATION baton rouge ] avoiding [SL:OBSTRUCTION_AVOID traffic ] ]
Is there a way to get  to the super bowl  without construction?	Is there a way to get to the super bowl without construction ?	[IN:GET_DIRECTIONS Is there a way to get to [SL:DESTINATION [IN:GET_EVENT [SL:CATEGORY_EVENT the super bowl ] ] ] without [SL:OBSTRUCTION_AVOID construction ] ? ]
What is my shortest traffic route to work this morning	What is my shortest traffic route to work this morning	[IN:GET_DIRECTIONS What is my shortest [SL:OBSTRUCTION_AVOID traffic ] route to [SL:DESTINATION [IN:GET_LOCATION_WORK work ] ] [SL:DATE_TIME_DEPARTURE this morning ] ]
What's the quickest route to avoid construction to make it home by 6pm?	What 's the quickest route to avoid construction to make it home by 6 pm ?	[IN:GET_DIRECTIONS What 's the quickest route to avoid [SL:OBSTRUCTION_AVOID construction ] to make it [SL:DESTINATION [IN:GET_LOCATION_HOME home ] ] [SL:DATE_TIME_ARRIVAL by 6 pm ] ? ]
How can I get around this accident to get to work faster right now?	How can I get around this accident to get to work faster right now ?	[IN:GET_DIRECTIONS How can I get around [SL:OBSTRUCTION_AVOID this accident ] to get to [SL:DESTINATION [IN:GET_LOCATION_WORK work ] ] faster [SL:DATE_TIME_DEPARTURE right now ] ? ]
Detour to avoid traffic	Detour to avoid traffic	[IN:GET_DIRECTIONS [SL:PATH Detour ] to avoid [SL:OBSTRUCTION_AVOID traffic ] ]
Get directions to downtown Baton Rouge without passing construction	Get directions to downtown Baton Rouge without passing construction	[IN:GET_DIRECTIONS Get directions to [SL:DESTINATION downtown Baton Rouge ] without passing [SL:OBSTRUCTION_AVOID construction ] ]
What is the route with the least traffic congestion	What is the route with the least traffic congestion	[IN:GET_DIRECTIONS What is the route with the least [SL:OBSTRUCTION_AVOID traffic congestion ] ]
How can I avoid the heavy traffic	How can I avoid the heavy traffic	[IN:GET_DIRECTIONS How can I avoid [SL:OBSTRUCTION_AVOID the heavy traffic ] ]
Where is the highway with the least traffic	Where is the highway with the least traffic	[IN:GET_INFO_TRAFFIC Where is [SL:LOCATION [IN:GET_LOCATION [SL:CATEGORY_LOCATION the highway ] ] ] with the least [SL:OBSTRUCTION_AVOID traffic ] ]
What time will I arrive at the train station if I drive without passing the construction?	What time will I arrive at the train station if I drive without passing the construction ?	[IN:GET_ESTIMATED_ARRIVAL What time will I arrive at [SL:DESTINATION [IN:GET_LOCATION [SL:CATEGORY_LOCATION the train station ] ] ] if I [SL:METHOD_TRAVEL drive ] without passing [SL:OBSTRUCTION_AVOID the construction ] ? ]
Please show me a route with less traffic	Please show me a route with less traffic	[IN:UPDATE_DIRECTIONS Please show me a route with less [SL:OBSTRUCTION_AVOID traffic ] ]
I want to arrive to Dan's by 5 and would like to know the best route to take to avoid traffic.	I want to arrive to Dan 's by 5 and would like to know the best route to take to avoid traffic .	[IN:GET_DIRECTIONS I want to arrive to [SL:DESTINATION [IN:GET_LOCATION_HOME [SL:CONTACT Dan ] 's ] ] [SL:DATE_TIME_ARRIVAL by 5 ] and would like to know the best route to take to avoid [SL:OBSTRUCTION_AVOID traffic ] . ]
what route has the least traffic	what route has the least traffic	[IN:GET_DIRECTIONS what route has the least [SL:OBSTRUCTION_AVOID traffic ] ]
How to avoid traffic to work	How to avoid traffic to work	[IN:GET_DIRECTIONS How to avoid [SL:OBSTRUCTION_AVOID traffic ] to [SL:DESTINATION [IN:GET_LOCATION_WORK work ] ] ]
Please provide light traffic routes	Please provide light traffic routes	[IN:GET_DIRECTIONS Please provide light [SL:OBSTRUCTION_AVOID traffic ] routes ]
Routes to avoid traffic	Routes to avoid traffic	[IN:GET_DIRECTIONS Routes to avoid [SL:OBSTRUCTION_AVOID traffic ] ]
Show me how I can get from my house to my dads house with the least amount of traffic	Show me how I can get from my house to my dads house with the least amount of traffic	[IN:GET_DIRECTIONS Show me how I can get from [SL:SOURCE [IN:GET_LOCATION_HOME [SL:CONTACT my ] house ] ] to [SL:DESTINATION [IN:GET_LOCATION_HOME [SL:CONTACT_RELATED my ] [SL:TYPE_RELATION dads ] house ] ] with the least amount of [SL:OBSTRUCTION_AVOID traffic ] ]
take me where there is less traffic	take me where there is less traffic	[IN:UPDATE_DIRECTIONS take me where there is less [SL:OBSTRUCTION_AVOID traffic ] ]
Find alternate route if there is traffic	Find alternate route if there is traffic	[IN:UPDATE_DIRECTIONS Find alternate route if there is [SL:OBSTRUCTION_AVOID traffic ] ]
Bypass traffic on 10th street from my location	Bypass traffic on 10th street from my location	[IN:GET_DIRECTIONS Bypass [SL:OBSTRUCTION_AVOID traffic ] on [SL:PATH 10th street ] from [SL:SOURCE [IN:GET_LOCATION [SL:LOCATION_USER my location ] ] ] ]
Is there any way I can make it to the local Walmart by 8:30 tonight if I avoid the road closure on 6 South?	Is there any way I can make it to the local Walmart by 8 : 30 tonight if I avoid the road closure on 6 South ?	[IN:GET_DIRECTIONS Is there any way I can make it to [SL:DESTINATION [IN:GET_LOCATION the [SL:LOCATION_MODIFIER local ] [SL:POINT_ON_MAP Walmart ] ] ] [SL:DATE_TIME_ARRIVAL by 8 : 30 tonight ] if I avoid [SL:OBSTRUCTION_AVOID the road closure ] on [SL:PATH_AVOID 6 South ] ? ]
Get me driving directions with no construction to Lincoln Zoo	Get me driving directions with no construction to Lincoln Zoo	[IN:GET_DIRECTIONS Get me [SL:METHOD_TRAVEL driving ] directions with no [SL:OBSTRUCTION_AVOID construction ] to [SL:DESTINATION [IN:GET_LOCATION [SL:POINT_ON_MAP Lincoln Zoo ] ] ] ]
avoid traffic	avoid traffic	[IN:GET_DIRECTIONS avoid [SL:OBSTRUCTION_AVOID traffic ] ]
how can i avoid construction	how can i avoid construction	[IN:GET_DIRECTIONS how can i avoid [SL:OBSTRUCTION_AVOID construction ] ]
Give me alternate routes to work to avoid heavy traffic	Give me alternate routes to work to avoid heavy traffic	[IN:UPDATE_DIRECTIONS Give me alternate routes to [SL:DESTINATION [IN:GET_LOCATION_WORK work ] ] to avoid heavy [SL:OBSTRUCTION_AVOID traffic ] ]
I need a way around this traffic	I need a way around this traffic	[IN:GET_DIRECTIONS I need a way around [SL:OBSTRUCTION_AVOID this traffic ] ]
I need to be in San Diego on Saturday before 12pm what route can I take avoiding traffic	I need to be in San Diego on Saturday before 12 pm what route can I take avoiding traffic	[IN:GET_DIRECTIONS I need to be in [SL:DESTINATION San Diego ] [SL:DATE_TIME_ARRIVAL on Saturday before 12 pm ] what route can I take avoiding [SL:OBSTRUCTION_AVOID traffic ] ]
Can I drive from Edmonds to Bellingham and avoid any highway construction?	Can I drive from Edmonds to Bellingham and avoid any highway construction ?	[IN:GET_INFO_TRAFFIC Can I [SL:METHOD_TRAVEL drive ] from [SL:SOURCE Edmonds ] to [SL:DESTINATION Bellingham ] and avoid any [SL:OBSTRUCTION_AVOID highway construction ] ? ]
Which route has the least amount of traffic	Which route has the least amount of traffic	[IN:GET_DIRECTIONS Which route has the least amount of [SL:OBSTRUCTION_AVOID traffic ] ]
Give me another route around this accident	Give me another route around this accident	[IN:UPDATE_DIRECTIONS Give me another route around [SL:OBSTRUCTION_AVOID this accident ] ]
What time should I drive to work to avoid traffic	What time should I drive to work to avoid traffic	[IN:GET_ESTIMATED_DEPARTURE What time should I [SL:METHOD_TRAVEL drive ] to [SL:DESTINATION [IN:GET_LOCATION_WORK work ] ] to avoid [SL:OBSTRUCTION_AVOID traffic ] ]
Is there any detours to Gina's house that will avoid traffic?	Is there any detours to Gina 's house that will avoid traffic ?	[IN:GET_DIRECTIONS Is there any [SL:PATH detours ] to [SL:DESTINATION [IN:GET_LOCATION_HOME [SL:CONTACT Gina ] 's house ] ] that will avoid [SL:OBSTRUCTION_AVOID traffic ] ? ]
How long will the traffic delay along my route take to get around?	How long will the traffic delay along my route take to get around ?	[IN:GET_ESTIMATED_DURATION How long will [SL:OBSTRUCTION_AVOID the traffic delay ] along my route take to get around ? ]
No traffic	No traffic	[IN:UPDATE_DIRECTIONS No [SL:OBSTRUCTION_AVOID traffic ] ]
Send instructions for arriving at the train station avoid routes with construction please.	Send instructions for arriving at the train station avoid routes with construction please .	[IN:GET_DIRECTIONS Send instructions for arriving at [SL:DESTINATION [IN:GET_LOCATION [SL:CATEGORY_LOCATION the train station ] ] ] avoid routes with [SL:OBSTRUCTION_AVOID construction ] please . ]
freeway jam what another way  get home	freeway jam what another way get home	[IN:UPDATE_DIRECTIONS [SL:OBSTRUCTION_AVOID freeway jam ] what another way get [SL:DESTINATION [IN:GET_LOCATION_HOME home ] ] ]
Which route has the lightest traffic from Portland to Seattle	Which route has the lightest traffic from Portland to Seattle	[IN:GET_DIRECTIONS Which route has the lightest [SL:OBSTRUCTION_AVOID traffic ] from [SL:SOURCE Portland ] to [SL:DESTINATION Seattle ] ]
What traffic areas should I avoid	What traffic areas should I avoid	[IN:GET_INFO_TRAFFIC What [SL:OBSTRUCTION_AVOID traffic areas ] should I avoid ]
which route should i take to get to work while avoiding traffic	which route should i take to get to work while avoiding traffic	[IN:GET_DIRECTIONS which route should i take to get to [SL:DESTINATION [IN:GET_LOCATION_WORK work ] ] while avoiding [SL:OBSTRUCTION_AVOID traffic ] ]
How do I get to Tampa from Kissimmee without having to pay tolls, and with no construction	How do I get to Tampa from Kissimmee without having to pay tolls , and with no construction	[IN:GET_DIRECTIONS How do I get to [SL:DESTINATION Tampa ] from [SL:SOURCE Kissimmee ] without having to pay [SL:PATH_AVOID [IN:GET_LOCATION [SL:CATEGORY_LOCATION tolls ] ] ] , and with no [SL:OBSTRUCTION_AVOID construction ] ]
what time should I leave from here to go home to miss traffic	what time should I leave from here to go home to miss traffic	[IN:GET_ESTIMATED_DEPARTURE what time should I leave from [SL:SOURCE [IN:GET_LOCATION [SL:LOCATION_USER here ] ] ] to go [SL:DESTINATION [IN:GET_LOCATION_HOME home ] ] to miss [SL:OBSTRUCTION_AVOID traffic ] ]
Any detour to avoid the afternoon traffic on I-95 to bensalem	Any detour to avoid the afternoon traffic on I - 95 to bensalem	[IN:GET_DIRECTIONS Any [SL:PATH [IN:GET_LOCATION [SL:CATEGORY_LOCATION detour ] ] ] to avoid the [SL:DATE_TIME_DEPARTURE afternoon ] [SL:OBSTRUCTION_AVOID traffic ] on I - 95 to [SL:DESTINATION bensalem ] ]
Get me driving directions to downtown Cincinnati without construction leaving at 1 pm.	Get me driving directions to downtown Cincinnati without construction leaving at 1 pm .	[IN:GET_DIRECTIONS Get me [SL:METHOD_TRAVEL driving ] directions to [SL:DESTINATION downtown Cincinnati ] without [SL:OBSTRUCTION_AVOID construction ] leaving [SL:DATE_TIME_DEPARTURE at 1 pm ] . ]
how can I avoid traffic	how can I avoid traffic	[IN:GET_DIRECTIONS how can I avoid [SL:OBSTRUCTION_AVOID traffic ] ]
Please give me a route to work with the least amount of traffic	Please give me a route to work with the least amount of traffic	[IN:GET_DIRECTIONS Please give me a route to [SL:DESTINATION [IN:GET_LOCATION_WORK work ] ] with the least amount of [SL:OBSTRUCTION_AVOID traffic ] ]
Where is the least traffic getting home	Where is the least traffic getting home	[IN:GET_DIRECTIONS Where is the least [SL:OBSTRUCTION_AVOID traffic ] getting [SL:DESTINATION [IN:GET_LOCATION_HOME home ] ] ]
find a route with less traffic	find a route with less traffic	[IN:UPDATE_DIRECTIONS find a route with less [SL:OBSTRUCTION_AVOID traffic ] ]
What is a a way to the concert that avoids traffic?	What is a a way to the concert that avoids traffic ?	[IN:GET_DIRECTIONS What is a a way to [SL:DESTINATION [IN:GET_EVENT [SL:CATEGORY_EVENT the concert ] ] ] that avoids [SL:OBSTRUCTION_AVOID traffic ] ? ]
i am starting at 5 PM from school avoiding construction traffic. when will i reach home	i am starting at 5 PM from school avoiding construction traffic . when will i reach home	[IN:GET_ESTIMATED_ARRIVAL i am starting [SL:DATE_TIME_DEPARTURE at 5 PM ] from [SL:SOURCE [IN:GET_LOCATION_SCHOOL school ] ] avoiding [SL:OBSTRUCTION_AVOID construction traffic ] . when will i reach [SL:DESTINATION [IN:GET_LOCATION_HOME home ] ] ]
What other route can I take to avoid the traffic delay	What other route can I take to avoid the traffic delay	[IN:UPDATE_DIRECTIONS What other route can I take to avoid [SL:OBSTRUCTION_AVOID the traffic delay ] ]
Can you give me directions to the east end without hitting the expressway traffic	Can you give me directions to the east end without hitting the expressway traffic	[IN:GET_DIRECTIONS Can you give me directions to [SL:DESTINATION the east end ] without hitting [SL:OBSTRUCTION_AVOID the expressway traffic ] ]
What time should I leave for work to avoid traffic	What time should I leave for work to avoid traffic	[IN:GET_ESTIMATED_DEPARTURE What time should I leave for [SL:DESTINATION [IN:GET_LOCATION_WORK work ] ] to avoid [SL:OBSTRUCTION_AVOID traffic ] ]
Alternate route around traffic	Alternate route around traffic	[IN:UPDATE_DIRECTIONS Alternate route around [SL:OBSTRUCTION_AVOID traffic ] ]
skip traffic	skip traffic	[IN:UPDATE_DIRECTIONS skip [SL:OBSTRUCTION_AVOID traffic ] ]
Whats the best detour to take from the construction on the way to San Jose?	Whats the best detour to take from the construction on the way to San Jose ?	[IN:GET_DIRECTIONS Whats the best detour to take from [SL:OBSTRUCTION_AVOID the construction ] on the way to [SL:DESTINATION San Jose ] ? ]
how long will it take for me to get from  Gonzales to the fishing rodeo at the bay front if I avoid the construction on highway 90	how long will it take for me to get from Gonzales to the fishing rodeo at the bay front if I avoid the construction on highway 90	[IN:GET_ESTIMATED_DURATION how long will it take for me to get from [SL:SOURCE Gonzales ] to [SL:DESTINATION [IN:GET_EVENT [SL:CATEGORY_EVENT the fishing rodeo ] at [SL:LOCATION the bay front ] ] ] if I avoid [SL:OBSTRUCTION_AVOID the construction on highway 90 ] ]
best detour to avoid traffic on the way to  the AT & T center from Joyce's house?	best detour to avoid traffic on the way to the AT & T center from Joyce 's house ?	[IN:GET_DIRECTIONS best [SL:PATH [IN:GET_LOCATION [SL:CATEGORY_LOCATION detour ] ] ] to avoid [SL:OBSTRUCTION_AVOID traffic ] on the way to [SL:DESTINATION [IN:GET_LOCATION [SL:POINT_ON_MAP the AT & T center ] ] ] from [SL:SOURCE [IN:GET_LOCATION_HOME [SL:CONTACT Joyce ] 's house ] ] ? ]
Find alternate route around traffic	Find alternate route around traffic	[IN:UPDATE_DIRECTIONS Find alternate route around [SL:OBSTRUCTION_AVOID traffic ] ]
whats the best detour route to avoid traffic	whats the best detour route to avoid traffic	[IN:GET_DIRECTIONS whats the best detour route to avoid [SL:OBSTRUCTION_AVOID traffic ] ]
get directions to Naples, without construction, to Vero Beach	get directions to Naples , without construction , to Vero Beach	[IN:GET_DIRECTIONS get directions to [SL:SOURCE Naples ] , without [SL:OBSTRUCTION_AVOID construction ] , to [SL:DESTINATION Vero Beach ] ]
where is the lightest traffic around town	where is the lightest traffic around town	[IN:GET_INFO_TRAFFIC where is the lightest [SL:OBSTRUCTION_AVOID traffic ] [SL:LOCATION [IN:GET_LOCATION [SL:SEARCH_RADIUS around ] [SL:CATEGORY_LOCATION town ] ] ] ]
What's the best way to get to Fenway park and avoid all the traffic?	What 's the best way to get to Fenway park and avoid all the traffic ?	[IN:GET_DIRECTIONS What 's the best way to get to [SL:DESTINATION [IN:GET_LOCATION [SL:POINT_ON_MAP Fenway park ] ] ] and avoid all [SL:OBSTRUCTION_AVOID the traffic ] ? ]
Is there an alternate route to avoid traffic	Is there an alternate route to avoid traffic	[IN:UPDATE_DIRECTIONS Is there an alternate route to avoid [SL:OBSTRUCTION_AVOID traffic ] ]
when should i leave for detroit for the least traffic	when should i leave for detroit for the least traffic	[IN:GET_ESTIMATED_DEPARTURE when should i leave for [SL:DESTINATION detroit ] for the least [SL:OBSTRUCTION_AVOID traffic ] ]
Show me the route with the lightest traffic on my way home from work	Show me the route with the lightest traffic on my way home from work	[IN:GET_DIRECTIONS Show me the route with the lightest [SL:OBSTRUCTION_AVOID traffic ] on my way [SL:DESTINATION [IN:GET_LOCATION_HOME home ] ] from [SL:SOURCE [IN:GET_LOCATION_WORK work ] ] ]
What route has the least traffic	What route has the least traffic	[IN:GET_DIRECTIONS What route has the least [SL:OBSTRUCTION_AVOID traffic ] ]
What is the best time to travel to avoid traffic	What is the best time to travel to avoid traffic	[IN:GET_ESTIMATED_DEPARTURE What is the best time to travel to avoid [SL:OBSTRUCTION_AVOID traffic ] ]
Is there a way to avoid this traffic	Is there a way to avoid this traffic	[IN:GET_DIRECTIONS Is there a way to avoid [SL:OBSTRUCTION_AVOID this traffic ] ]
What time should I leave to beat traffic to Minneapolis in the morning	What time should I leave to beat traffic to Minneapolis in the morning	[IN:GET_ESTIMATED_DEPARTURE What time should I leave to beat [SL:OBSTRUCTION_AVOID traffic ] to [SL:DESTINATION Minneapolis ] [SL:DATE_TIME_DEPARTURE in the morning ] ]
alternative route that bypass traffic jam	alternative route that bypass traffic jam	[IN:UPDATE_DIRECTIONS alternative route that bypass [SL:OBSTRUCTION_AVOID traffic jam ] ]
What is the fastest route home from work, avoiding tolls and traffic	What is the fastest route home from work , avoiding tolls and traffic	[IN:GET_DIRECTIONS What is the fastest route [SL:DESTINATION [IN:GET_LOCATION_HOME home ] ] from [SL:SOURCE [IN:GET_LOCATION_WORK work ] ] , avoiding [SL:PATH_AVOID [IN:GET_LOCATION [SL:CATEGORY_LOCATION tolls ] ] ] and [SL:OBSTRUCTION_AVOID traffic ] ]
Find me the route with the least amount of traffic	Find me the route with the least amount of traffic	[IN:GET_DIRECTIONS Find me the route with the least amount of [SL:OBSTRUCTION_AVOID traffic ] ]
how can I avoid road work when going to taylors aunts house leaving from my office	how can I avoid road work when going to taylors aunts house leaving from my office	[IN:GET_DIRECTIONS how can I avoid [SL:OBSTRUCTION_AVOID road work ] when going to [SL:DESTINATION [IN:GET_LOCATION_HOME [SL:CONTACT_RELATED taylors ] [SL:TYPE_RELATION aunts ] house ] ] leaving from [SL:SOURCE [IN:GET_LOCATION_WORK [SL:CONTACT my ] office ] ] ]
What is the fastest route to Pittston to avoid interstate traffic?	What is the fastest route to Pittston to avoid interstate traffic ?	[IN:GET_DIRECTIONS What is the fastest route to [SL:DESTINATION Pittston ] to avoid interstate [SL:OBSTRUCTION_AVOID traffic ] ? ]
Can you bring up directions from Duluth to Minneapolis, avoiding construction?	Can you bring up directions from Duluth to Minneapolis , avoiding construction ?	[IN:GET_DIRECTIONS Can you bring up directions from [SL:SOURCE Duluth ] to [SL:DESTINATION Minneapolis ] , avoiding [SL:OBSTRUCTION_AVOID construction ] ? ]
How long is it to go around this construction	How long is it to go around this construction	[IN:GET_ESTIMATED_DURATION How long is it to go around [SL:OBSTRUCTION_AVOID this construction ] ]
If I avoid roadwork what is the fastest route from my house to Tennessee	If I avoid roadwork what is the fastest route from my house to Tennessee	[IN:GET_DIRECTIONS If I avoid [SL:OBSTRUCTION_AVOID roadwork ] what is the fastest route from [SL:SOURCE [IN:GET_LOCATION_HOME [SL:CONTACT my ] house ] ] to [SL:DESTINATION Tennessee ] ]
I need directions from the outlet mall in San Marcos to New Braunfels without construction	I need directions from the outlet mall in San Marcos to New Braunfels without construction	[IN:GET_DIRECTIONS I need directions from [SL:SOURCE [IN:GET_LOCATION [SL:CATEGORY_LOCATION the outlet mall ] in [SL:LOCATION_MODIFIER San Marcos ] ] ] to [SL:DESTINATION New Braunfels ] without [SL:OBSTRUCTION_AVOID construction ] ]
Tell me the route to Meredith's house that has the least amount of traffic	Tell me the route to Meredith 's house that has the least amount of traffic	[IN:GET_DIRECTIONS Tell me the route to [SL:DESTINATION [IN:GET_LOCATION_HOME [SL:CONTACT Meredith ] 's house ] ] that has the least amount of [SL:OBSTRUCTION_AVOID traffic ] ]
is there a faster way that avoids traffic	is there a faster way that avoids traffic	[IN:UPDATE_DIRECTIONS is there a faster way that avoids [SL:OBSTRUCTION_AVOID traffic ] ]
Construction-free routes to Moreno Valley under 2 hours	Construction - free routes to Moreno Valley under 2 hours	[IN:GET_DIRECTIONS [SL:OBSTRUCTION_AVOID Construction ] - free routes to [SL:DESTINATION Moreno Valley ] [SL:DATE_TIME_ARRIVAL under 2 hours ] ]
what is the best time to leave tomorrow to avoid heavy traffic	what is the best time to leave tomorrow to avoid heavy traffic	[IN:GET_ESTIMATED_DEPARTURE what is the best time to leave [SL:DATE_TIME_DEPARTURE tomorrow ] to avoid heavy [SL:OBSTRUCTION_AVOID traffic ] ]
Which way should I take to not get stuck in traffic when I leave at 2pm to pick up the girls at school?	Which way should I take to not get stuck in traffic when I leave at 2 pm to pick up the girls at school ?	[IN:GET_DIRECTIONS Which way should I take to not get stuck in [SL:OBSTRUCTION_AVOID traffic ] when I leave [SL:DATE_TIME_DEPARTURE at 2 pm ] to pick up the girls at [SL:DESTINATION [IN:GET_LOCATION_SCHOOL school ] ] ? ]
I need directions to avoid the traffic on I-65	I need directions to avoid the traffic on I - 65	[IN:GET_DIRECTIONS I need directions to avoid [SL:OBSTRUCTION_AVOID the traffic on I - 65 ] ]
Directions from home to the airport without traffic please, arriving at 4pm	Directions from home to the airport without traffic please , arriving at 4 pm	[IN:GET_DIRECTIONS Directions from [SL:SOURCE [IN:GET_LOCATION_HOME home ] ] to [SL:DESTINATION [IN:GET_LOCATION [SL:CATEGORY_LOCATION the airport ] ] ] without [SL:OBSTRUCTION_AVOID traffic ] please , arriving [SL:DATE_TIME_ARRIVAL at 4 pm ] ]
How long will it take me to get to work without construction if I take the highway	How long will it take me to get to work without construction if I take the highway	[IN:GET_ESTIMATED_DURATION How long will it take me to get to [SL:DESTINATION [IN:GET_LOCATION_WORK work ] ] without [SL:OBSTRUCTION_AVOID construction ] if I take [SL:PATH [IN:GET_LOCATION [SL:CATEGORY_LOCATION the highway ] ] ] ]
What detours are clear of traffic from downtown	What detours are clear of traffic from downtown	[IN:GET_INFO_TRAFFIC What [SL:PATH [IN:GET_LOCATION [SL:CATEGORY_LOCATION detours ] ] ] are clear of [SL:OBSTRUCTION_AVOID traffic ] from [SL:SOURCE downtown ] ]
Directions to avoid the construction on the Palisades Parkway.	Directions to avoid the construction on the Palisades Parkway .	[IN:GET_DIRECTIONS Directions to avoid [SL:OBSTRUCTION_AVOID the construction ] on [SL:PATH_AVOID the Palisades Parkway ] . ]
What is the best way to get to Shepherdsville without running into traffic	What is the best way to get to Shepherdsville without running into traffic	[IN:GET_DIRECTIONS What is the best way to get to [SL:DESTINATION Shepherdsville ] without running into [SL:OBSTRUCTION_AVOID traffic ] ]
Routes to avoid accidents	Routes to avoid accidents	[IN:GET_DIRECTIONS Routes to avoid [SL:OBSTRUCTION_AVOID accidents ] ]
Directions to Walmart in Douglasville avoiding construction	Directions to Walmart in Douglasville avoiding construction	[IN:GET_DIRECTIONS Directions to [SL:DESTINATION [IN:GET_LOCATION [SL:POINT_ON_MAP Walmart ] in [SL:LOCATION_MODIFIER Douglasville ] ] ] avoiding [SL:OBSTRUCTION_AVOID construction ] ]
Is there a route without construction	Is there a route without construction	[IN:GET_DIRECTIONS Is there a route without [SL:OBSTRUCTION_AVOID construction ] ]
what time should i leave to avoid traffic to the browns game	what time should i leave to avoid traffic to the browns game	[IN:GET_ESTIMATED_DEPARTURE what time should i leave to avoid [SL:OBSTRUCTION_AVOID traffic ] to [SL:DESTINATION [IN:GET_EVENT [SL:NAME_EVENT the browns ] [SL:CATEGORY_EVENT game ] ] ] ]
Tell me the best way to avoid traffic delays if I go into Sylva on Friday afternoon. on I-40.	Tell me the best way to avoid traffic delays if I go into Sylva on Friday afternoon . on I - 40 .	[IN:GET_DIRECTIONS Tell me the best way to avoid [SL:OBSTRUCTION_AVOID traffic delays ] if I go into [SL:DESTINATION Sylva ] [SL:DATE_TIME_ARRIVAL on Friday afternoon ] . on [SL:PATH I - 40 ] . ]
Is there a way to get from 1st Ave & Main St Portland to the Pearl District Street Festival without construction?	Is there a way to get from 1st Ave & Main St Portland to the Pearl District Street Festival without construction ?	[IN:GET_DIRECTIONS Is there a way to get from [SL:SOURCE [IN:GET_LOCATION [SL:LOCATION 1st Ave ] & [SL:LOCATION Main St ] [SL:LOCATION_MODIFIER Portland ] ] ] to [SL:DESTINATION [IN:GET_EVENT [SL:CATEGORY_EVENT the Pearl District Street Festival ] ] ] without [SL:OBSTRUCTION_AVOID construction ] ? ]
Show me construction areas to avoid	Show me construction areas to avoid	[IN:GET_INFO_TRAFFIC Show me [SL:OBSTRUCTION_AVOID construction areas ] to avoid ]
Get directions home from Penn medical center in Cherry Hill, avoiding Rt 295 construction.	Get directions home from Penn medical center in Cherry Hill , avoiding Rt 295 construction .	[IN:GET_DIRECTIONS Get directions [SL:DESTINATION [IN:GET_LOCATION_HOME home ] ] from [SL:SOURCE [IN:GET_LOCATION [SL:POINT_ON_MAP Penn medical center ] in [SL:LOCATION_MODIFIER Cherry Hill ] ] ] , avoiding Rt 295 [SL:OBSTRUCTION_AVOID construction ] . ]
Is there an alternate route to bypass the traffic on the 5 freeway by street to get to my 5pm meeting in Los Angeles?	Is there an alternate route to bypass the traffic on the 5 freeway by street to get to my 5 pm meeting in Los Angeles ?	[IN:UPDATE_DIRECTIONS Is there an alternate route to bypass [SL:OBSTRUCTION_AVOID the traffic ] on the 5 freeway by street to get to [SL:DESTINATION [IN:GET_EVENT [SL:ORGANIZER_EVENT my ] [SL:DATE_TIME 5 pm ] [SL:CATEGORY_EVENT meeting ] in [SL:LOCATION Los Angeles ] ] ] ? ]
I have to pick up my computer and Micro Center and Madison Heights what's the least congested route to get there from Mt. Clemens	I have to pick up my computer and Micro Center and Madison Heights what 's the least congested route to get there from Mt . Clemens	[IN:GET_DIRECTIONS I have to pick up my computer and [SL:DESTINATION [IN:GET_LOCATION [SL:POINT_ON_MAP Micro Center ] and [SL:LOCATION_MODIFIER Madison Heights ] ] ] what 's the least [SL:OBSTRUCTION_AVOID congested ] route to get there from [SL:SOURCE Mt . Clemens ] ]
What is the best route without roadwork to the Veteran's Hospital in Mobile, AL, if I am leaving at 8:00AM?	What is the best route without roadwork to the Veteran 's Hospital in Mobile , AL , if I am leaving at 8 : 00AM ?	[IN:GET_DIRECTIONS What is the best route without [SL:OBSTRUCTION_AVOID roadwork ] to [SL:DESTINATION [IN:GET_LOCATION [SL:POINT_ON_MAP the Veteran 's Hospital ] in [SL:LOCATION_MODIFIER Mobile , AL ] ] ] , if I am leaving [SL:DATE_TIME_DEPARTURE at 8 : 00AM ] ? ]
Can I get to the soccer game at 100 puffnstuf street without going into heavy traffic?	Can I get to the soccer game at 100 puffnstuf street without going into heavy traffic ?	[IN:GET_DIRECTIONS Can I get to [SL:DESTINATION [IN:GET_EVENT [SL:CATEGORY_EVENT the soccer game ] at [SL:LOCATION 100 puffnstuf street ] ] ] without going into heavy [SL:OBSTRUCTION_AVOID traffic ] ? ]
Can you give me a route that has little traffic	Can you give me a route that has little traffic	[IN:GET_DIRECTIONS Can you give me a route that has little [SL:OBSTRUCTION_AVOID traffic ] ]
Which way to the airport has the least traffic	Which way to the airport has the least traffic	[IN:GET_DIRECTIONS Which way to [SL:DESTINATION [IN:GET_LOCATION [SL:CATEGORY_LOCATION the airport ] ] ] has the least [SL:OBSTRUCTION_AVOID traffic ] ]
Route with the least traffic from here to Cleveland	Route with the least traffic from here to Cleveland	[IN:GET_DIRECTIONS Route with the least [SL:OBSTRUCTION_AVOID traffic ] from [SL:SOURCE [IN:GET_LOCATION [SL:LOCATION_USER here ] ] ] to [SL:DESTINATION Cleveland ] ]
What is the best route to avoid traffic to Town Center today	What is the best route to avoid traffic to Town Center today	[IN:GET_DIRECTIONS What is the best route to avoid [SL:OBSTRUCTION_AVOID traffic ] to [SL:DESTINATION [IN:GET_LOCATION [SL:POINT_ON_MAP Town Center ] ] ] [SL:DATE_TIME_DEPARTURE today ] ]
What is the best time with the least traffic to drive from Vallejo to Black hawk tomorrow	What is the best time with the least traffic to drive from Vallejo to Black hawk tomorrow	[IN:GET_ESTIMATED_DEPARTURE What is the best time with the least [SL:OBSTRUCTION_AVOID traffic ] to [SL:METHOD_TRAVEL drive ] from [SL:SOURCE Vallejo ] to [SL:DESTINATION Black hawk ] [SL:DATE_TIME_DEPARTURE tomorrow ] ]
Which way has less traffic to get to Carolina Forest High School	Which way has less traffic to get to Carolina Forest High School	[IN:GET_DIRECTIONS Which way has less [SL:OBSTRUCTION_AVOID traffic ] to get to [SL:DESTINATION [IN:GET_LOCATION [SL:POINT_ON_MAP Carolina Forest High School ] ] ] ]
Avoid heavy traffic routes please	Avoid heavy traffic routes please	[IN:GET_DIRECTIONS Avoid heavy [SL:OBSTRUCTION_AVOID traffic ] routes please ]
Get me to the fish market using I-90 and avoiding construction	Get me to the fish market using I - 90 and avoiding construction	[IN:GET_DIRECTIONS Get me to [SL:DESTINATION [IN:GET_LOCATION [SL:CATEGORY_LOCATION the fish market ] ] ] using [SL:PATH I - 90 ] and avoiding [SL:OBSTRUCTION_AVOID construction ] ]
Soccer practice ends at 12pm, what route home should I take to avoid the mid day traffic?	Soccer practice ends at 12 pm , what route home should I take to avoid the mid day traffic ?	[IN:GET_DIRECTIONS [SL:SOURCE [IN:GET_EVENT [SL:CATEGORY_EVENT Soccer practice ] ] ] ends [SL:DATE_TIME_DEPARTURE at 12 pm ] , what route [SL:DESTINATION [IN:GET_LOCATION_HOME home ] ] should I take to avoid [SL:OBSTRUCTION_AVOID the mid day traffic ] ? ]
Get directions to downtown Chicago without passing construction.	Get directions to downtown Chicago without passing construction .	[IN:GET_DIRECTIONS Get directions to [SL:DESTINATION downtown Chicago ] without passing [SL:OBSTRUCTION_AVOID construction ] . ]
The country music festival starts at 3pm, what's the best way to get there without running into any traffic?	The country music festival starts at 3 pm , what 's the best way to get there without running into any traffic ?	[IN:GET_DIRECTIONS [SL:DESTINATION [IN:GET_EVENT [SL:CATEGORY_EVENT The country music festival ] starts [SL:DATE_TIME at 3 pm ] ] ] , what 's the best way to get there without running into any [SL:OBSTRUCTION_AVOID traffic ] ? ]
what route should i take to pasadena to avoid traffic at 5pm	what route should i take to pasadena to avoid traffic at 5 pm	[IN:GET_DIRECTIONS what route should i take to [SL:DESTINATION pasadena ] to avoid [SL:OBSTRUCTION_AVOID traffic ] [SL:DATE_TIME_DEPARTURE at 5 pm ] ]
which route has the least traffic	which route has the least traffic	[IN:GET_DIRECTIONS which route has the least [SL:OBSTRUCTION_AVOID traffic ] ]
when can i leave without being caught in traffic	when can i leave without being caught in traffic	[IN:GET_ESTIMATED_DEPARTURE when can i leave without being caught in [SL:OBSTRUCTION_AVOID traffic ] ]
How can I avoid this traffic	How can I avoid this traffic	[IN:GET_DIRECTIONS How can I avoid [SL:OBSTRUCTION_AVOID this traffic ] ]
How can I avoid the traffic jam between south and pearl street	How can I avoid the traffic jam between south and pearl street	[IN:GET_DIRECTIONS How can I avoid [SL:OBSTRUCTION_AVOID the traffic jam between south and pearl street ] ]
Alternate route to avoid traffic	Alternate route to avoid traffic	[IN:UPDATE_DIRECTIONS Alternate route to avoid [SL:OBSTRUCTION_AVOID traffic ] ]
What is the fastest route to the police station without construction?	What is the fastest route to the police station without construction ?	[IN:GET_DIRECTIONS What is the fastest route to [SL:DESTINATION [IN:GET_LOCATION [SL:CATEGORY_LOCATION the police station ] ] ] without [SL:OBSTRUCTION_AVOID construction ] ? ]
Help me avoid traffic going home	Help me avoid traffic going home	[IN:GET_DIRECTIONS Help me avoid [SL:OBSTRUCTION_AVOID traffic ] going [SL:DESTINATION [IN:GET_LOCATION_HOME home ] ] ]
What time shall I leave for 1pm appointment to avoid the traffic jam ?	What time shall I leave for 1 pm appointment to avoid the traffic jam ?	[IN:GET_ESTIMATED_DEPARTURE What time shall I leave for [SL:DESTINATION [IN:GET_EVENT [SL:DATE_TIME 1 pm ] [SL:CATEGORY_EVENT appointment ] ] ] to avoid [SL:OBSTRUCTION_AVOID the traffic jam ] ? ]
Best route to avoid traffic	Best route to avoid traffic	[IN:GET_DIRECTIONS Best route to avoid [SL:OBSTRUCTION_AVOID traffic ] ]
how can i avoid traffic on bardstown rd	how can i avoid traffic on bardstown rd	[IN:GET_DIRECTIONS how can i avoid [SL:OBSTRUCTION_AVOID traffic on bardstown rd ] ]
Find the way with least traffic to get to Valley River Mall	Find the way with least traffic to get to Valley River Mall	[IN:GET_DIRECTIONS Find the way with least [SL:OBSTRUCTION_AVOID traffic ] to get to [SL:DESTINATION [IN:GET_LOCATION [SL:POINT_ON_MAP Valley River Mall ] ] ] ]
THERE IS TRAFFIC ON HWY 101 SO IS THERE AN EXIT I CAN TAKE THAT WILL GET ME TO MY SPA APPOINTMENT  ON TIME BY 11 AM	THERE IS TRAFFIC ON HWY 101 SO IS THERE AN EXIT I CAN TAKE THAT WILL GET ME TO MY SPA APPOINTMENT ON TIME BY 11 AM	[IN:GET_DIRECTIONS THERE IS [SL:OBSTRUCTION_AVOID TRAFFIC ON HWY 101 ] SO IS THERE [SL:PATH [IN:GET_LOCATION [SL:CATEGORY_LOCATION AN EXIT ] ] ] I CAN TAKE THAT WILL GET ME TO [SL:DESTINATION [IN:GET_EVENT [SL:ORGANIZER_EVENT MY ] [SL:CATEGORY_EVENT SPA APPOINTMENT ] ] ] ON TIME [SL:DATE_TIME_ARRIVAL BY 11 AM ] ]
Which road should I take to avoid traffic if I want to drive downtown at 5pm?	Which road should I take to avoid traffic if I want to drive downtown at 5 pm ?	[IN:GET_DIRECTIONS Which road should I take to avoid [SL:OBSTRUCTION_AVOID traffic ] if I want to [SL:METHOD_TRAVEL drive ] [SL:DESTINATION downtown ] [SL:DATE_TIME_DEPARTURE at 5 pm ] ? ]
what route can I take to avoid an accident	what route can I take to avoid an accident	[IN:GET_DIRECTIONS what route can I take to avoid an [SL:OBSTRUCTION_AVOID accident ] ]
Show me the best way to get to the Jim Carey show without hitting the construction on I-84.	Show me the best way to get to the Jim Carey show without hitting the construction on I - 84 .	[IN:GET_DIRECTIONS Show me the best way to get to [SL:DESTINATION [IN:GET_EVENT the [SL:NAME_EVENT Jim Carey ] [SL:CATEGORY_EVENT show ] ] ] without hitting [SL:OBSTRUCTION_AVOID the construction on I - 84 ] . ]
what time would i arrive to nasr city taking the ring road to avoid traffic jam?	what time would i arrive to nasr city taking the ring road to avoid traffic jam ?	[IN:GET_ESTIMATED_ARRIVAL what time would i arrive to [SL:DESTINATION nasr city ] taking [SL:PATH the ring road ] to avoid [SL:OBSTRUCTION_AVOID traffic jam ] ? ]
How long will it take me to get to Detroit without construction on the turnpike	How long will it take me to get to Detroit without construction on the turnpike	[IN:GET_ESTIMATED_DURATION How long will it take me to get to [SL:DESTINATION Detroit ] without [SL:OBSTRUCTION_AVOID construction ] on [SL:PATH [IN:GET_LOCATION [SL:CATEGORY_LOCATION the turnpike ] ] ] ]
Can we go around the heavy traffic areas	Can we go around the heavy traffic areas	[IN:UPDATE_DIRECTIONS Can we go around the heavy [SL:OBSTRUCTION_AVOID traffic ] areas ]
no traffic routes please	no traffic routes please	[IN:GET_DIRECTIONS no [SL:OBSTRUCTION_AVOID traffic ] routes please ]
calculate a route to San Fransisco that avoids road work	calculate a route to San Fransisco that avoids road work	[IN:GET_DIRECTIONS calculate a route to [SL:DESTINATION San Fransisco ] that avoids [SL:OBSTRUCTION_AVOID road work ] ]
WHAT IS THE ROUTE TO TAKE TO AVOID TRAFFIC	WHAT IS THE ROUTE TO TAKE TO AVOID TRAFFIC	[IN:GET_DIRECTIONS WHAT IS THE ROUTE TO TAKE TO AVOID [SL:OBSTRUCTION_AVOID TRAFFIC ] ]
How long does it take to get to Chicago without traffic	How long does it take to get to Chicago without traffic	[IN:GET_ESTIMATED_DURATION How long does it take to get to [SL:DESTINATION Chicago ] without [SL:OBSTRUCTION_AVOID traffic ] ]
What is the easiest way around traffic	What is the easiest way around traffic	[IN:GET_DIRECTIONS What is the easiest way around [SL:OBSTRUCTION_AVOID traffic ] ]
Which route can I take to avoid the roads that are closed for construction near my grandmother's place?	Which route can I take to avoid the roads that are closed for construction near my grandmother 's place ?	[IN:GET_DIRECTIONS Which route can I take to avoid the roads that are closed for [SL:OBSTRUCTION_AVOID construction ] [SL:LOCATION [IN:GET_LOCATION [SL:SEARCH_RADIUS near ] [SL:LOCATION [IN:GET_LOCATION_HOME [SL:CONTACT_RELATED my ] [SL:TYPE_RELATION grandmother ] 's place ] ] ] ] ? ]
Is there a better route to avoid traffic	Is there a better route to avoid traffic	[IN:UPDATE_DIRECTIONS Is there a better route to avoid [SL:OBSTRUCTION_AVOID traffic ] ]
Is there any way to avoid the construction on 440 and get from here to Hillsborough?	Is there any way to avoid the construction on 440 and get from here to Hillsborough ?	[IN:GET_DIRECTIONS Is there any way to avoid [SL:OBSTRUCTION_AVOID the construction ] on [SL:PATH 440 ] and get from [SL:SOURCE [IN:GET_LOCATION [SL:LOCATION_USER here ] ] ] to [SL:DESTINATION Hillsborough ] ? ]
How long will is the drive to Virginia beach without traffic	How long will is the drive to Virginia beach without traffic	[IN:GET_ESTIMATED_DURATION How long will is the [SL:METHOD_TRAVEL drive ] to [SL:DESTINATION Virginia beach ] without [SL:OBSTRUCTION_AVOID traffic ] ]
is there an alternate route with less traffic	is there an alternate route with less traffic	[IN:UPDATE_DIRECTIONS is there an alternate route with less [SL:OBSTRUCTION_AVOID traffic ] ]
Avoid traffic	Avoid traffic	[IN:GET_DIRECTIONS Avoid [SL:OBSTRUCTION_AVOID traffic ] ]
Which route has the least traffic to Poway	Which route has the least traffic to Poway	[IN:GET_DIRECTIONS Which route has the least [SL:OBSTRUCTION_AVOID traffic ] to [SL:DESTINATION Poway ] ]
what is the best way to go to avoid traffic	what is the best way to go to avoid traffic	[IN:GET_DIRECTIONS what is the best way to go to avoid [SL:OBSTRUCTION_AVOID traffic ] ]
What time should I leave work tonight if I don't want to sit in traffic?	What time should I leave work tonight if I don't want to sit in traffic ?	[IN:GET_ESTIMATED_DEPARTURE What time should I leave [SL:SOURCE [IN:GET_LOCATION_WORK work ] ] [SL:DATE_TIME_DEPARTURE tonight ] if I don't want to sit in [SL:OBSTRUCTION_AVOID traffic ] ? ]
How do I avoid stop and go traffic on the way to Franklin	How do I avoid stop and go traffic on the way to Franklin	[IN:GET_DIRECTIONS How do I avoid stop and go [SL:OBSTRUCTION_AVOID traffic ] on the way to [SL:DESTINATION Franklin ] ]
Is there an alternate route to avoid so much traffic	Is there an alternate route to avoid so much traffic	[IN:UPDATE_DIRECTIONS Is there an alternate route to avoid so much [SL:OBSTRUCTION_AVOID traffic ] ]
Will I make it to the events by 12 pm if there is no downed power lines?	Will I make it to the events by 12 pm if there is no downed power lines ?	[IN:GET_ESTIMATED_ARRIVAL Will I make it to [SL:DESTINATION [IN:GET_EVENT the events ] ] [SL:DATE_TIME_ARRIVAL by 12 pm ] if there is no [SL:OBSTRUCTION_AVOID downed power lines ] ? ]
when can i leave to work and avoid traffic	when can i leave to work and avoid traffic	[IN:GET_ESTIMATED_DEPARTURE when can i leave to [SL:DESTINATION [IN:GET_LOCATION_WORK work ] ] and avoid [SL:OBSTRUCTION_AVOID traffic ] ]
leaving at 3 pm from work what is the quickest route avoiding construction to my daughters school	leaving at 3 pm from work what is the quickest route avoiding construction to my daughters school	[IN:GET_DIRECTIONS leaving [SL:DATE_TIME_DEPARTURE at 3 pm ] from [SL:SOURCE [IN:GET_LOCATION_WORK work ] ] what is the quickest route avoiding [SL:OBSTRUCTION_AVOID construction ] to [SL:DESTINATION [IN:GET_LOCATION_SCHOOL [SL:CONTACT_RELATED my ] [SL:TYPE_RELATION daughters ] school ] ] ]
Can I take back roads to miss some traffic	Can I take back roads to miss some traffic	[IN:GET_DIRECTIONS Can I take [SL:PATH back roads ] to miss some [SL:OBSTRUCTION_AVOID traffic ] ]
What route will how the least traffic delays at this time to reach Waterford Lakes Town Center from my house	What route will how the least traffic delays at this time to reach Waterford Lakes Town Center from my house	[IN:GET_DIRECTIONS What route will how the least [SL:OBSTRUCTION_AVOID traffic delays ] [SL:DATE_TIME_DEPARTURE at this time ] to reach [SL:DESTINATION [IN:GET_LOCATION [SL:POINT_ON_MAP Waterford Lakes Town Center ] ] ] from [SL:SOURCE [IN:GET_LOCATION_HOME [SL:CONTACT my ] house ] ] ]
how can i avoid the accident on the way to zacks house	how can i avoid the accident on the way to zacks house	[IN:GET_DIRECTIONS how can i avoid [SL:OBSTRUCTION_AVOID the accident ] on the way to [SL:DESTINATION [IN:GET_LOCATION_HOME [SL:CONTACT zacks ] house ] ] ]
show me routes to work that avoid traffic	show me routes to work that avoid traffic	[IN:GET_DIRECTIONS show me routes to [SL:DESTINATION [IN:GET_LOCATION_WORK work ] ] that avoid [SL:OBSTRUCTION_AVOID traffic ] ]
Get directions to downtown Mandeville without passing construction	Get directions to downtown Mandeville without passing construction	[IN:GET_DIRECTIONS Get directions to [SL:DESTINATION downtown Mandeville ] without passing [SL:OBSTRUCTION_AVOID construction ] ]
when should i leave to miss traffic	when should i leave to miss traffic	[IN:GET_ESTIMATED_DEPARTURE when should i leave to miss [SL:OBSTRUCTION_AVOID traffic ] ]
Are there any shortcuts around this traffic that would get me home quicker	Are there any shortcuts around this traffic that would get me home quicker	[IN:UPDATE_DIRECTIONS Are there any shortcuts around [SL:OBSTRUCTION_AVOID this traffic ] that would get me [SL:DESTINATION [IN:GET_LOCATION_HOME home ] ] quicker ]
Can i take a taxi to the Beyonce concert tonight without traffic?	Can i take a taxi to the Beyonce concert tonight without traffic ?	[IN:GET_DIRECTIONS Can i take a [SL:METHOD_TRAVEL taxi ] to [SL:DESTINATION [IN:GET_EVENT the [SL:NAME_EVENT Beyonce ] [SL:CATEGORY_EVENT concert ] [SL:DATE_TIME tonight ] ] ] without [SL:OBSTRUCTION_AVOID traffic ] ? ]
directions to denver with least amount of traffic	directions to denver with least amount of traffic	[IN:GET_DIRECTIONS directions to [SL:DESTINATION denver ] with least amount of [SL:OBSTRUCTION_AVOID traffic ] ]
tell me where it has less traffic	tell me where it has less traffic	[IN:GET_INFO_TRAFFIC tell me where it has less [SL:OBSTRUCTION_AVOID traffic ] ]
can you tell me how to get to the sears tower from work avoiding contruction	can you tell me how to get to the sears tower from work avoiding contruction	[IN:GET_DIRECTIONS can you tell me how to get to [SL:DESTINATION [IN:GET_LOCATION [SL:POINT_ON_MAP the sears tower ] ] ] from [SL:SOURCE [IN:GET_LOCATION_WORK work ] ] avoiding [SL:OBSTRUCTION_AVOID contruction ] ]
Best way to get to the Golf course avoiding traffic	Best way to get to the Golf course avoiding traffic	[IN:GET_DIRECTIONS Best way to get to [SL:DESTINATION [IN:GET_LOCATION [SL:CATEGORY_LOCATION the Golf course ] ] ] avoiding [SL:OBSTRUCTION_AVOID traffic ] ]
How do I avoid traffic on the way to Bellevue	How do I avoid traffic on the way to Bellevue	[IN:GET_DIRECTIONS How do I avoid [SL:OBSTRUCTION_AVOID traffic ] on the way to [SL:DESTINATION Bellevue ] ]
whats the fastest route home avoiding traffic	whats the fastest route home avoiding traffic	[IN:GET_DIRECTIONS whats the fastest route [SL:DESTINATION [IN:GET_LOCATION_HOME home ] ] avoiding [SL:OBSTRUCTION_AVOID traffic ] ]
Is there a way to get to Main St. without running into construction?	Is there a way to get to Main St . without running into construction ?	[IN:GET_DIRECTIONS Is there a way to get to [SL:DESTINATION Main St . ] without running into [SL:OBSTRUCTION_AVOID construction ] ? ]
Give me the time to Greg's house using back roads so I can avoid the traffic.	Give me the time to Greg 's house using back roads so I can avoid the traffic .	[IN:GET_ESTIMATED_DURATION Give me the time to [SL:DESTINATION [IN:GET_LOCATION_HOME [SL:CONTACT Greg ] 's house ] ] using [SL:PATH [IN:GET_LOCATION [SL:CATEGORY_LOCATION back roads ] ] ] so I can avoid [SL:OBSTRUCTION_AVOID the traffic ] . ]
what's the shortest route with the least traffic	what 's the shortest route with the least traffic	[IN:GET_DIRECTIONS what 's the shortest route with the least [SL:OBSTRUCTION_AVOID traffic ] ]
Get directions from home to the airport without traffic, leaving at 4pm	Get directions from home to the airport without traffic , leaving at 4 pm	[IN:GET_DIRECTIONS Get directions from [SL:SOURCE [IN:GET_LOCATION_HOME home ] ] to [SL:DESTINATION [IN:GET_LOCATION [SL:CATEGORY_LOCATION the airport ] ] ] without [SL:OBSTRUCTION_AVOID traffic ] , leaving [SL:DATE_TIME_DEPARTURE at 4 pm ] ]
Which way is the shortest route home from work avoiding traffic	Which way is the shortest route home from work avoiding traffic	[IN:GET_DIRECTIONS Which way is the shortest route [SL:DESTINATION [IN:GET_LOCATION_HOME home ] ] from [SL:SOURCE [IN:GET_LOCATION_WORK work ] ] avoiding [SL:OBSTRUCTION_AVOID traffic ] ]
Can I avoid the traffic	Can I avoid the traffic	[IN:GET_INFO_TRAFFIC Can I avoid [SL:OBSTRUCTION_AVOID the traffic ] ]
Which route to the Hospital has the least traffic	Which route to the Hospital has the least traffic	[IN:GET_DIRECTIONS Which route to [SL:DESTINATION [IN:GET_LOCATION [SL:CATEGORY_LOCATION the Hospital ] ] ] has the least [SL:OBSTRUCTION_AVOID traffic ] ]
how do i get to the bank on main street from my house avoiding the down power lines on maple street	how do i get to the bank on main street from my house avoiding the down power lines on maple street	[IN:GET_DIRECTIONS how do i get to [SL:DESTINATION [IN:GET_LOCATION [SL:CATEGORY_LOCATION the bank ] on [SL:LOCATION_MODIFIER main street ] ] ] from [SL:SOURCE [IN:GET_LOCATION_HOME [SL:CONTACT my ] house ] ] avoiding [SL:OBSTRUCTION_AVOID the down power lines ] on [SL:PATH maple street ] ]
Which back roads can I take to avoid traffic	Which back roads can I take to avoid traffic	[IN:GET_DIRECTIONS Which [SL:PATH [IN:GET_LOCATION [SL:CATEGORY_LOCATION back roads ] ] ] can I take to avoid [SL:OBSTRUCTION_AVOID traffic ] ]
what time should i leave to make it to my 9am meeting if i want to avoid the construction	what time should i leave to make it to my 9 am meeting if i want to avoid the construction	[IN:GET_ESTIMATED_DEPARTURE what time should i leave to make it to [SL:DESTINATION [IN:GET_EVENT [SL:ORGANIZER_EVENT my ] [SL:DATE_TIME 9 am ] [SL:CATEGORY_EVENT meeting ] ] ] if i want to avoid [SL:OBSTRUCTION_AVOID the construction ] ]
Can I avoid traffic traveling from Savannah, GA to Miami	Can I avoid traffic traveling from Savannah , GA to Miami	[IN:GET_DIRECTIONS Can I avoid [SL:OBSTRUCTION_AVOID traffic ] traveling from [SL:SOURCE Savannah , GA ] to [SL:DESTINATION Miami ] ]
route with least traffic to san jose	route with least traffic to san jose	[IN:GET_DIRECTIONS route with least [SL:OBSTRUCTION_AVOID traffic ] to [SL:DESTINATION san jose ] ]
take me least congested route to my brother David's house	take me least congested route to my brother David 's house	[IN:GET_DIRECTIONS take me least [SL:OBSTRUCTION_AVOID congested ] route to [SL:DESTINATION [IN:GET_LOCATION_HOME [SL:CONTACT_RELATED my ] [SL:TYPE_RELATION brother ] [SL:CONTACT David ] 's house ] ] ]
Get me the driving directions to universal studios from here if I avoid high traffic areas	Get me the driving directions to universal studios from here if I avoid high traffic areas	[IN:GET_DIRECTIONS Get me the [SL:METHOD_TRAVEL driving ] directions to [SL:DESTINATION [IN:GET_LOCATION [SL:POINT_ON_MAP universal studios ] ] ] from [SL:SOURCE [IN:GET_LOCATION [SL:LOCATION_USER here ] ] ] if I avoid high [SL:OBSTRUCTION_AVOID traffic ] areas ]
Tell me the fastest way home from Keansburg because I think there are downed power lines on route 35	Tell me the fastest way home from Keansburg because I think there are downed power lines on route 35	[IN:GET_DIRECTIONS Tell me the fastest way [SL:DESTINATION [IN:GET_LOCATION_HOME home ] ] from [SL:SOURCE Keansburg ] because I think there are [SL:OBSTRUCTION_AVOID downed power lines ] on route 35 ]
How long would it take to get to work if I took all side streets avoiding any construction	How long would it take to get to work if I took all side streets avoiding any construction	[IN:GET_ESTIMATED_DURATION How long would it take to get to [SL:DESTINATION [IN:GET_LOCATION_WORK work ] ] if I took all [SL:PATH side streets ] avoiding any [SL:OBSTRUCTION_AVOID construction ] ]
There is an accident ahead how long will it take me to get to the office going an alternate route?	There is an accident ahead how long will it take me to get to the office going an alternate route ?	[IN:GET_ESTIMATED_DURATION There is an [SL:OBSTRUCTION_AVOID accident ] ahead how long will it take me to get to [SL:DESTINATION [IN:GET_LOCATION_WORK the office ] ] going an alternate route ? ]
show me wrecks to avoid on the interstate	show me wrecks to avoid on the interstate	[IN:GET_INFO_TRAFFIC show me [SL:OBSTRUCTION_AVOID wrecks ] to avoid on [SL:LOCATION [IN:GET_LOCATION [SL:CATEGORY_LOCATION the interstate ] ] ] ]
Is there an alternative route with less traffic	Is there an alternative route with less traffic	[IN:UPDATE_DIRECTIONS Is there an alternative route with less [SL:OBSTRUCTION_AVOID traffic ] ]
what is the best route to avoid traffic to carls recital	what is the best route to avoid traffic to carls recital	[IN:GET_DIRECTIONS what is the best route to avoid [SL:OBSTRUCTION_AVOID traffic ] to [SL:DESTINATION [IN:GET_EVENT [SL:ATTENDEE_EVENT carls ] [SL:CATEGORY_EVENT recital ] ] ] ]
what is the best route to get around the womens march	what is the best route to get around the womens march	[IN:GET_DIRECTIONS what is the best route to get around [SL:OBSTRUCTION_AVOID the womens march ] ]
How can avoid traffic from the accident on my way to work	How can avoid traffic from the accident on my way to work	[IN:GET_DIRECTIONS How can avoid [SL:OBSTRUCTION_AVOID traffic from the accident ] on my way to [SL:DESTINATION [IN:GET_LOCATION_WORK work ] ] ]
how do I get to my meeting this afternoon if I avoided the construction	how do I get to my meeting this afternoon if I avoided the construction	[IN:GET_DIRECTIONS how do I get to [SL:DESTINATION [IN:GET_EVENT [SL:ORGANIZER_EVENT my ] [SL:CATEGORY_EVENT meeting ] [SL:DATE_TIME this afternoon ] ] ] if I avoided [SL:OBSTRUCTION_AVOID the construction ] ]
