Is there any fog on Hwy 43 between Greenville and Conetoe this morning?	Is there any fog on Hwy 43 between Greenville and Conetoe this morning ?	[IN:GET_INFO_ROAD_CONDITION Is there any [SL:ROAD_CONDITION fog ] on [SL:PATH Hwy 43 ] between [SL:SOURCE Greenville ] and [SL:DESTINATION Conetoe ] [SL:DATE_TIME this morning ] ? ]
How many roads are flooded today?	How many roads are flooded today ?	[IN:GET_INFO_ROAD_CONDITION How many roads are [SL:ROAD_CONDITION flooded ] [SL:DATE_TIME today ] ? ]
How much rain fell on the I229 area	How much rain fell on the I229 area	[IN:GET_INFO_ROAD_CONDITION How much [SL:ROAD_CONDITION rain ] fell on [SL:LOCATION the I229 area ] ]
How is the 55 north affected by the flood?	How is the 55 north affected by the flood ?	[IN:GET_INFO_ROAD_CONDITION How is [SL:LOCATION the 55 north ] affected by [SL:ROAD_CONDITION the flood ] ? ]
Please tell me if the roads are icy this evening	Please tell me if the roads are icy this evening	[IN:GET_INFO_ROAD_CONDITION Please tell me if the roads are [SL:ROAD_CONDITION icy ] [SL:DATE_TIME this evening ] ]
are the road still snowy this evening?	are the road still snowy this evening ?	[IN:GET_INFO_ROAD_CONDITION are the road still [SL:ROAD_CONDITION snowy ] [SL:DATE_TIME this evening ] ? ]
Are the roads still icy this morning	Are the roads still icy this morning	[IN:GET_INFO_ROAD_CONDITION Are the roads still [SL:ROAD_CONDITION icy ] [SL:DATE_TIME this morning ] ]
Are the roads icy on the freeway?	Are the roads icy on the freeway ?	[IN:GET_INFO_ROAD_CONDITION Are the roads [SL:ROAD_CONDITION icy ] on [SL:LOCATION [IN:GET_LOCATION [SL:CATEGORY_LOCATION the freeway ] ] ] ? ]
How is the ice on I-40	How is the ice on I - 40	[IN:GET_INFO_ROAD_CONDITION How is [SL:ROAD_CONDITION the ice ] on [SL:LOCATION I - 40 ] ]
What's the condition of the road today since it's freezing temps and it rained last night?	What 's the condition of the road today since it 's freezing temps and it rained last night ?	[IN:GET_INFO_ROAD_CONDITION What 's the condition of the road [SL:DATE_TIME today ] since it 's [SL:ROAD_CONDITION freezing temps ] and it [SL:ROAD_CONDITION rained ] last night ? ]
Are the roads flooded by my mom and dad's house?	Are the roads flooded by my mom and dad 's house ?	[IN:GET_INFO_ROAD_CONDITION Are the roads [SL:ROAD_CONDITION flooded ] [SL:LOCATION [IN:GET_LOCATION [SL:SEARCH_RADIUS by ] [SL:LOCATION [IN:GET_LOCATION_HOME [SL:CONTACT_RELATED my ] [SL:TYPE_RELATION mom ] and [SL:TYPE_RELATION dad ] 's house ] ] ] ] ? ]
Are the roads icy this afternoon?	Are the roads icy this afternoon ?	[IN:GET_INFO_ROAD_CONDITION Are the roads [SL:ROAD_CONDITION icy ] [SL:DATE_TIME this afternoon ] ? ]
Is there any flooding on the highway from the rain last night?	Is there any flooding on the highway from the rain last night ?	[IN:GET_INFO_ROAD_CONDITION Is there any [SL:ROAD_CONDITION flooding ] on [SL:LOCATION [IN:GET_LOCATION [SL:CATEGORY_LOCATION the highway ] ] ] from the rain last night ? ]
Will I be hitting any flooding that will alter my goal to be in Minneapolis by 1pm?	Will I be hitting any flooding that will alter my goal to be in Minneapolis by 1 pm ?	[IN:GET_INFO_ROAD_CONDITION Will I be hitting any [SL:ROAD_CONDITION flooding ] that will alter my goal to be in [SL:DESTINATION Minneapolis ] [SL:DATE_TIME_ARRIVAL by 1 pm ] ? ]
any flooded roads?	any flooded roads ?	[IN:GET_INFO_ROAD_CONDITION any [SL:ROAD_CONDITION flooded ] roads ? ]
Is there any ice and snow on my way to work 7 am?	Is there any ice and snow on my way to work 7 am ?	[IN:GET_INFO_ROAD_CONDITION Is there any [SL:ROAD_CONDITION ice ] and [SL:ROAD_CONDITION snow ] on my way to [SL:DESTINATION [IN:GET_LOCATION_WORK work ] ] [SL:DATE_TIME 7 am ] ? ]
Is there bad weather on the highway?	Is there bad weather on the highway ?	[IN:GET_INFO_ROAD_CONDITION Is there bad weather on [SL:LOCATION [IN:GET_LOCATION [SL:CATEGORY_LOCATION the highway ] ] ] ? ]
Can I expect icy road conditions on my way to Ed Sheeran's concert?	Can I expect icy road conditions on my way to Ed Sheeran 's concert ?	[IN:GET_INFO_ROAD_CONDITION Can I expect [SL:ROAD_CONDITION icy ] road conditions on my way to [SL:DESTINATION [IN:GET_EVENT [SL:NAME_EVENT Ed Sheeran ] 's [SL:CATEGORY_EVENT concert ] ] ] ? ]
Is the weather affecting traffic today	Is the weather affecting traffic today	[IN:GET_INFO_ROAD_CONDITION Is the weather affecting traffic [SL:DATE_TIME today ] ]
Is there flooding on 17 business this morning?	Is there flooding on 17 business this morning ?	[IN:GET_INFO_ROAD_CONDITION Is there [SL:ROAD_CONDITION flooding ] on [SL:LOCATION 17 business ] [SL:DATE_TIME this morning ] ? ]
Is it raining through the route I need to go to work right now	Is it raining through the route I need to go to work right now	[IN:GET_INFO_ROAD_CONDITION Is it [SL:ROAD_CONDITION raining ] through the route I need to go to [SL:DESTINATION [IN:GET_LOCATION_WORK work ] ] [SL:DATE_TIME right now ] ]
What streets in Rochester, NY have been plowed today	What streets in Rochester , NY have been plowed today	[IN:GET_INFO_ROAD_CONDITION What streets in [SL:LOCATION Rochester , NY ] have been [SL:ROAD_CONDITION plowed ] [SL:DATE_TIME today ] ]
What are road conditions From Benkelman to Trenton on Highway 34	What are road conditions From Benkelman to Trenton on Highway 34	[IN:GET_INFO_ROAD_CONDITION What are road conditions From [SL:SOURCE Benkelman ] to [SL:DESTINATION Trenton ] on [SL:PATH Highway 34 ] ]
Is there any flooding on the roads between here and the hospital?	Is there any flooding on the roads between here and the hospital ?	[IN:GET_INFO_ROAD_CONDITION Is there any [SL:ROAD_CONDITION flooding ] on the roads between [SL:SOURCE [IN:GET_LOCATION [SL:LOCATION_USER here ] ] ] and [SL:DESTINATION [IN:GET_LOCATION [SL:CATEGORY_LOCATION the hospital ] ] ] ? ]
are there any flooding on my way to work today?	are there any flooding on my way to work today ?	[IN:GET_INFO_ROAD_CONDITION are there any [SL:ROAD_CONDITION flooding ] on my way to [SL:DESTINATION [IN:GET_LOCATION_WORK work ] ] [SL:DATE_TIME_DEPARTURE today ] ? ]
Are there any flooded roads between the mississippi coast coliseum for the concert and my brother's house	Are there any flooded roads between the mississippi coast coliseum for the concert and my brother 's house	[IN:GET_INFO_ROAD_CONDITION Are there any [SL:ROAD_CONDITION flooded ] roads between [SL:SOURCE [IN:GET_EVENT [SL:LOCATION [IN:GET_LOCATION [SL:POINT_ON_MAP the mississippi coast coliseum ] ] ] for [SL:CATEGORY_EVENT the concert ] ] ] and [SL:DESTINATION [IN:GET_LOCATION_HOME [SL:CONTACT_RELATED my ] [SL:TYPE_RELATION brother ] 's house ] ] ]
Are there any icy conditions in Dallas?	Are there any icy conditions in Dallas ?	[IN:GET_INFO_ROAD_CONDITION Are there any [SL:ROAD_CONDITION icy ] conditions in [SL:LOCATION Dallas ] ? ]
Are there any trees down on Brownsville Rd.	Are there any trees down on Brownsville Rd .	[IN:GET_INFO_ROAD_CONDITION Are there any [SL:ROAD_CONDITION trees down ] on [SL:LOCATION Brownsville Rd ] . ]
Will I run into ice and snow on my way to the Selena Gomez concert?	Will I run into ice and snow on my way to the Selena Gomez concert ?	[IN:GET_INFO_ROAD_CONDITION Will I run into [SL:ROAD_CONDITION ice ] and [SL:ROAD_CONDITION snow ] on my way to [SL:DESTINATION [IN:GET_EVENT the [SL:NAME_EVENT Selena Gomez ] [SL:CATEGORY_EVENT concert ] ] ] ? ]
Are the roads to Waterbury, Vermont open?  I thought they were flooded out.	Are the roads to Waterbury , Vermont open ? I thought they were flooded out .	[IN:GET_INFO_ROAD_CONDITION Are the roads to [SL:DESTINATION Waterbury , Vermont ] open ? I thought they were [SL:ROAD_CONDITION flooded ] out . ]
Is Washington Ave. plowed?	Is Washington Ave . plowed ?	[IN:GET_INFO_ROAD_CONDITION Is [SL:LOCATION Washington Ave . ] [SL:ROAD_CONDITION plowed ] ? ]
How is the hail effecting the drive to Stockton	How is the hail effecting the drive to Stockton	[IN:GET_INFO_ROAD_CONDITION How is [SL:ROAD_CONDITION the hail ] effecting the [SL:METHOD_TRAVEL drive ] to [SL:DESTINATION Stockton ] ]
Are there any black ice on the Belt Parkway this morning?	Are there any black ice on the Belt Parkway this morning ?	[IN:GET_INFO_ROAD_CONDITION Are there any [SL:ROAD_CONDITION black ice ] on [SL:LOCATION the Belt Parkway ] [SL:DATE_TIME this morning ] ? ]
Are the freeway roads slick this evening?	Are the freeway roads slick this evening ?	[IN:GET_INFO_ROAD_CONDITION Are [SL:LOCATION [IN:GET_LOCATION [SL:CATEGORY_LOCATION the freeway roads ] ] ] [SL:ROAD_CONDITION slick ] [SL:DATE_TIME this evening ] ? ]
Is the snow plowed on Little Mack between 10 Mile and 12 Mile?	Is the snow plowed on Little Mack between 10 Mile and 12 Mile ?	[IN:GET_INFO_ROAD_CONDITION Is [SL:ROAD_CONDITION the snow ] plowed on [SL:PATH Little Mack ] between [SL:SOURCE 10 Mile ] and [SL:DESTINATION 12 Mile ] ? ]
How is visibility	How is visibility	[IN:GET_INFO_ROAD_CONDITION How is visibility ]
Are the roads to Liz's house icy this morning?	Are the roads to Liz 's house icy this morning ?	[IN:GET_INFO_ROAD_CONDITION Are the roads to [SL:DESTINATION [IN:GET_LOCATION_HOME [SL:CONTACT Liz ] 's house ] ] [SL:ROAD_CONDITION icy ] [SL:DATE_TIME this morning ] ? ]
Is there snow on the bicycle path right now?	Is there snow on the bicycle path right now ?	[IN:GET_INFO_ROAD_CONDITION Is there [SL:ROAD_CONDITION snow ] on [SL:LOCATION [IN:GET_LOCATION [SL:CATEGORY_LOCATION the bicycle path ] ] ] [SL:DATE_TIME right now ] ? ]
Are the roads flooding this morning ?	Are the roads flooding this morning ?	[IN:GET_INFO_ROAD_CONDITION Are the roads [SL:ROAD_CONDITION flooding ] [SL:DATE_TIME this morning ] ? ]
Is there snow on my route to Flagstaff?	Is there snow on my route to Flagstaff ?	[IN:GET_INFO_ROAD_CONDITION Is there [SL:ROAD_CONDITION snow ] on my route to [SL:DESTINATION Flagstaff ] ? ]
can anyone get the news about weather on the freeway	can anyone get the news about weather on the freeway	[IN:GET_INFO_ROAD_CONDITION can anyone get the news about weather on [SL:LOCATION [IN:GET_LOCATION [SL:CATEGORY_LOCATION the freeway ] ] ] ]
Can you tell me if there is icy roads on the way to St. Thomas Hospital?	Can you tell me if there is icy roads on the way to St . Thomas Hospital ?	[IN:GET_INFO_ROAD_CONDITION Can you tell me if there is [SL:ROAD_CONDITION icy ] roads on the way to [SL:DESTINATION St . Thomas Hospital ] ? ]
Can you tell me if there is downed power lines between 2nd Street and 3rd Street in Seattle?	Can you tell me if there is downed power lines between 2nd Street and 3rd Street in Seattle ?	[IN:GET_INFO_ROAD_CONDITION Can you tell me if there is [SL:ROAD_CONDITION downed power lines ] between [SL:SOURCE 2nd Street ] and [SL:DESTINATION 3rd Street ] in [SL:LOCATION Seattle ] ? ]
Is the road going to the Lover's Festival icy?	Is the road going to the Lover 's Festival icy ?	[IN:GET_INFO_ROAD_CONDITION Is the road going to [SL:DESTINATION [IN:GET_EVENT [SL:CATEGORY_EVENT the Lover 's Festival ] ] ] [SL:ROAD_CONDITION icy ] ? ]
how are the road conditions nearby	how are the road conditions nearby	[IN:GET_INFO_ROAD_CONDITION how are the road conditions [SL:LOCATION [IN:GET_LOCATION [SL:LOCATION_MODIFIER nearby ] ] ] ]
Is there any flooding on I-95 South?	Is there any flooding on I - 95 South ?	[IN:GET_INFO_ROAD_CONDITION Is there [SL:ROAD_CONDITION any flooding ] on [SL:LOCATION I - 95 South ] ? ]
Are the highways icy this morning?	Are the highways icy this morning ?	[IN:GET_INFO_ROAD_CONDITION Are [SL:LOCATION [IN:GET_LOCATION [SL:CATEGORY_LOCATION the highways ] ] ] [SL:ROAD_CONDITION icy ] [SL:DATE_TIME this morning ] ? ]
Is there a lot of snow on Jackie Robinson Parkway?	Is there a lot of snow on Jackie Robinson Parkway ?	[IN:GET_INFO_ROAD_CONDITION Is there a lot of [SL:ROAD_CONDITION snow ] on [SL:LOCATION Jackie Robinson Parkway ] ? ]
Can you tell me if there is a lot of fog on my trip to Brewster right now?	Can you tell me if there is a lot of fog on my trip to Brewster right now ?	[IN:GET_INFO_ROAD_CONDITION Can you tell me if there is a lot of [SL:ROAD_CONDITION fog ] on my trip to [SL:DESTINATION Brewster ] [SL:DATE_TIME right now ] ? ]
Is Route 515 flooded near Pequannock	Is Route 515 flooded near Pequannock	[IN:GET_INFO_ROAD_CONDITION Is [SL:LOCATION Route 515 ] [SL:ROAD_CONDITION flooded ] [SL:LOCATION [IN:GET_LOCATION [SL:SEARCH_RADIUS near ] [SL:LOCATION Pequannock ] ] ] ]
Tell me which roads have icy conditions in Oklahoma City.	Tell me which roads have icy conditions in Oklahoma City .	[IN:GET_INFO_ROAD_CONDITION Tell me which roads have [SL:ROAD_CONDITION icy ] conditions in [SL:LOCATION Oklahoma City ] . ]
Should I be concerned about slipping on icy roads towards the mall?	Should I be concerned about slipping on icy roads towards the mall ?	[IN:GET_INFO_ROAD_CONDITION Should I be concerned about slipping on [SL:ROAD_CONDITION icy ] roads towards [SL:DESTINATION [IN:GET_LOCATION [SL:CATEGORY_LOCATION the mall ] ] ] ? ]
Is the rain making it  hard to get to the rugby tournament today?	Is the rain making it hard to get to the rugby tournament today ?	[IN:GET_INFO_ROAD_CONDITION Is [SL:ROAD_CONDITION the rain ] making it hard to get to [SL:DESTINATION [IN:GET_EVENT [SL:CATEGORY_EVENT the rugby tournament ] [SL:DATE_TIME today ] ] ] ? ]
are the roads flooded on the way to the Strawberry Festival from Boerne?	are the roads flooded on the way to the Strawberry Festival from Boerne ?	[IN:GET_INFO_ROAD_CONDITION are the roads [SL:ROAD_CONDITION flooded ] on the way to [SL:DESTINATION [IN:GET_EVENT [SL:CATEGORY_EVENT the Strawberry Festival ] ] ] from [SL:SOURCE Boerne ] ? ]
have the snow plows run in town yet or are the roads still covered?	have the snow plows run in town yet or are the roads still covered ?	[IN:GET_INFO_ROAD_CONDITION have the [SL:ROAD_CONDITION snow ] plows run in [SL:LOCATION [IN:GET_LOCATION [SL:CATEGORY_LOCATION town ] ] ] yet or are the roads still covered ? ]
Will there be sleet at 4pm when I ride my motercycle on my way to New Hampshire	Will there be sleet at 4 pm when I ride my motercycle on my way to New Hampshire	[IN:GET_INFO_ROAD_CONDITION Will there be [SL:ROAD_CONDITION sleet ] [SL:DATE_TIME at 4 pm ] when I ride my [SL:METHOD_TRAVEL motercycle ] on my way to [SL:DESTINATION New Hampshire ] ]
After the storm are there any downed power lines blocking the roads in Moore?	After the storm are there any downed power lines blocking the roads in Moore ?	[IN:GET_INFO_ROAD_CONDITION After the storm are there [SL:ROAD_CONDITION any downed power lines ] blocking the roads in [SL:LOCATION Moore ] ? ]
Are the roads going to Crookston icy?	Are the roads going to Crookston icy ?	[IN:GET_INFO_ROAD_CONDITION Are the roads going to [SL:DESTINATION Crookston ] [SL:ROAD_CONDITION icy ] ? ]
What do the current road conditions between work and home look like if I leave now?	What do the current road conditions between work and home look like if I leave now ?	[IN:GET_INFO_ROAD_CONDITION What do [SL:ROAD_CONDITION the current road conditions ] between [SL:SOURCE [IN:GET_LOCATION_WORK work ] ] and [SL:DESTINATION [IN:GET_LOCATION_HOME home ] ] look like if I leave [SL:DATE_TIME_DEPARTURE now ] ? ]
Is the underpass flooded by Cracker Barrel?	Is the underpass flooded by Cracker Barrel ?	[IN:GET_INFO_ROAD_CONDITION Is [SL:LOCATION [IN:GET_LOCATION [SL:CATEGORY_LOCATION the underpass ] ] ] [SL:ROAD_CONDITION flooded ] by [SL:LOCATION [IN:GET_LOCATION [SL:POINT_ON_MAP Cracker Barrel ] ] ] ? ]
Are the roads plowed on Kane Drive now?	Are the roads plowed on Kane Drive now ?	[IN:GET_INFO_ROAD_CONDITION Are the roads [SL:ROAD_CONDITION plowed ] on [SL:LOCATION Kane Drive ] [SL:DATE_TIME now ] ? ]
Can you tell me if there's flooding in streets right now ?	Can you tell me if there 's flooding in streets right now ?	[IN:GET_INFO_ROAD_CONDITION Can you tell me if there 's [SL:ROAD_CONDITION flooding ] in streets [SL:DATE_TIME right now ] ? ]
Are the roads flooded right now?	Are the roads flooded right now ?	[IN:GET_INFO_ROAD_CONDITION Are the roads [SL:ROAD_CONDITION flooded ] [SL:DATE_TIME right now ] ? ]
any ice on the roads to mom's house?	any ice on the roads to mom 's house ?	[IN:GET_INFO_ROAD_CONDITION any [SL:ROAD_CONDITION ice ] on the roads to [SL:DESTINATION [IN:GET_LOCATION_HOME [SL:TYPE_RELATION mom ] 's house ] ] ? ]
Is there any flooding between Ahoskie and Suffolk	Is there any flooding between Ahoskie and Suffolk	[IN:GET_INFO_ROAD_CONDITION Is there any [SL:ROAD_CONDITION flooding ] between [SL:SOURCE Ahoskie ] and [SL:DESTINATION Suffolk ] ]
Has landslide been cleared on PCH	Has landslide been cleared on PCH	[IN:GET_INFO_ROAD_CONDITION Has [SL:ROAD_CONDITION landslide ] been cleared on [SL:LOCATION PCH ] ]
Is I-40 closed for snow this weekend?	Is I - 40 closed for snow this weekend ?	[IN:GET_INFO_ROAD_CONDITION Is [SL:LOCATION I - 40 ] closed for [SL:ROAD_CONDITION snow ] [SL:DATE_TIME this weekend ] ? ]
Is there snow on the roads right now?	Is there snow on the roads right now ?	[IN:GET_INFO_ROAD_CONDITION Is there [SL:ROAD_CONDITION snow ] on the roads [SL:DATE_TIME right now ] ? ]
Are the roads still icy near Duxbury Beach?	Are the roads still icy near Duxbury Beach ?	[IN:GET_INFO_ROAD_CONDITION Are the roads still [SL:ROAD_CONDITION icy ] [SL:LOCATION [IN:GET_LOCATION [SL:SEARCH_RADIUS near ] [SL:LOCATION Duxbury Beach ] ] ] ? ]
Are the roads still wet from the storm lastnight?	Are the roads still wet from the storm lastnight ?	[IN:GET_INFO_ROAD_CONDITION Are the roads still [SL:ROAD_CONDITION wet ] from the storm lastnight ? ]
Is there any flooded roads on my route	Is there any flooded roads on my route	[IN:GET_INFO_ROAD_CONDITION Is there any [SL:ROAD_CONDITION flooded ] roads on my route ]
Are the way to Alexandria color festival icy today?	Are the way to Alexandria color festival icy today ?	[IN:GET_INFO_ROAD_CONDITION Are the way to [SL:DESTINATION [IN:GET_EVENT [SL:LOCATION Alexandria ] [SL:CATEGORY_EVENT color festival ] ] ] [SL:ROAD_CONDITION icy ] [SL:DATE_TIME today ] ? ]
Is the road icy on Walton Street?	Is the road icy on Walton Street ?	[IN:GET_INFO_ROAD_CONDITION Is the road [SL:ROAD_CONDITION icy ] on [SL:LOCATION Walton Street ] ? ]
How icy are the roads this morning	How icy are the roads this morning	[IN:GET_INFO_ROAD_CONDITION How [SL:ROAD_CONDITION icy ] are the roads [SL:DATE_TIME this morning ] ]
Is there any ice reported on the road to work	Is there any ice reported on the road to work	[IN:GET_INFO_ROAD_CONDITION Is there any [SL:ROAD_CONDITION ice ] reported on the road to [SL:DESTINATION [IN:GET_LOCATION_WORK work ] ] ]
any roads flooded on the way to work?	any roads flooded on the way to work ?	[IN:GET_INFO_ROAD_CONDITION any roads [SL:ROAD_CONDITION flooded ] on the way to [SL:DESTINATION [IN:GET_LOCATION_WORK work ] ] ? ]
Is there a lot of snow still on the roads going to school?	Is there a lot of snow still on the roads going to school ?	[IN:GET_INFO_ROAD_CONDITION Is there a lot of [SL:ROAD_CONDITION snow ] still on the roads going to [SL:DESTINATION [IN:GET_LOCATION_SCHOOL school ] ] ? ]
Are the roads covered with ice and snow between my house and Jeff's?	Are the roads covered with ice and snow between my house and Jeff 's ?	[IN:GET_INFO_ROAD_CONDITION Are the roads covered with [SL:ROAD_CONDITION ice ] and [SL:ROAD_CONDITION snow ] between [SL:SOURCE [IN:GET_LOCATION_HOME [SL:CONTACT my ] house ] ] and [SL:DESTINATION [IN:GET_LOCATION_HOME [SL:CONTACT Jeff ] 's ] ] ? ]
Did the rain cause the bridge road to flood?	Did the rain cause the bridge road to flood ?	[IN:GET_INFO_ROAD_CONDITION Did the rain cause [SL:LOCATION [IN:GET_LOCATION [SL:CATEGORY_LOCATION the bridge road ] ] ] to [SL:ROAD_CONDITION flood ] ? ]
Are there any icy roads on the way to my massage appointment?	Are there any icy roads on the way to my massage appointment ?	[IN:GET_INFO_ROAD_CONDITION Are there any [SL:ROAD_CONDITION icy ] roads on the way to [SL:DESTINATION [IN:GET_EVENT [SL:ATTENDEE_EVENT my ] [SL:CATEGORY_EVENT massage appointment ] ] ] ? ]
anyone reporting slick roads in boulder	anyone reporting slick roads in boulder	[IN:GET_INFO_ROAD_CONDITION anyone reporting [SL:ROAD_CONDITION slick ] roads in [SL:LOCATION boulder ] ]
Has South Boulder Road been plowed this morning	Has South Boulder Road been plowed this morning	[IN:GET_INFO_ROAD_CONDITION Has [SL:LOCATION South Boulder Road ] been plowed [SL:DATE_TIME this morning ] ]
Is there flooding now on Interstate 96?	Is there flooding now on Interstate 96 ?	[IN:GET_INFO_ROAD_CONDITION Is there [SL:ROAD_CONDITION flooding ] [SL:DATE_TIME now ] on [SL:LOCATION Interstate 96 ] ? ]
is there any downed power to Giza city?	is there any downed power to Giza city ?	[IN:GET_INFO_ROAD_CONDITION is there [SL:ROAD_CONDITION any downed power ] to [SL:DESTINATION Giza city ] ? ]
Did the snow get cleared from Park Avenue this morning?	Did the snow get cleared from Park Avenue this morning ?	[IN:GET_INFO_ROAD_CONDITION Did [SL:ROAD_CONDITION the snow ] get cleared from [SL:LOCATION Park Avenue ] [SL:DATE_TIME this morning ] ? ]
Are the roads flooded this morning?	Are the roads flooded this morning ?	[IN:GET_INFO_ROAD_CONDITION Are the roads [SL:ROAD_CONDITION flooded ] [SL:DATE_TIME this morning ] ? ]
will the lanes be visible on freeway in this snowy weather ?	will the lanes be visible on freeway in this snowy weather ?	[IN:GET_INFO_ROAD_CONDITION will the lanes be visible on [SL:LOCATION [IN:GET_LOCATION [SL:CATEGORY_LOCATION freeway ] ] ] in [SL:ROAD_CONDITION this snowy weather ] ? ]
Is there any flooding on my route to the Dunkin Donuts Center?	Is there any flooding on my route to the Dunkin Donuts Center ?	[IN:GET_INFO_ROAD_CONDITION Is there [SL:ROAD_CONDITION any flooding ] on my route to [SL:DESTINATION the Dunkin Donuts Center ] ? ]
How is the visibility if i leave home at 4am	How is the visibility if i leave home at 4 am	[IN:GET_INFO_ROAD_CONDITION How is [SL:ROAD_CONDITION the visibility ] if i leave [SL:SOURCE [IN:GET_LOCATION_HOME home ] ] [SL:DATE_TIME_DEPARTURE at 4 am ] ]
Is the fog slowing down freeway 5	Is the fog slowing down freeway 5	[IN:GET_INFO_ROAD_CONDITION Is [SL:ROAD_CONDITION the fog ] slowing down [SL:LOCATION freeway 5 ] ]
DId they plow the snow on Hoes Lane last night?	DId they plow the snow on Hoes Lane last night ?	[IN:GET_INFO_ROAD_CONDITION DId they plow [SL:ROAD_CONDITION the snow ] on [SL:LOCATION Hoes Lane ] [SL:DATE_TIME last night ] ? ]
Are the roads icy this morning on the way to Tina's house?	Are the roads icy this morning on the way to Tina 's house ?	[IN:GET_INFO_ROAD_CONDITION Are the roads [SL:ROAD_CONDITION icy ] [SL:DATE_TIME this morning ] on the way to [SL:DESTINATION [IN:GET_LOCATION_HOME [SL:CONTACT Tina ] 's house ] ] ? ]
Are the roads icy tonight?	Are the roads icy tonight ?	[IN:GET_INFO_ROAD_CONDITION Are the roads [SL:ROAD_CONDITION icy ] [SL:DATE_TIME tonight ] ? ]
Are the roads slippery this afternoon	Are the roads slippery this afternoon	[IN:GET_INFO_ROAD_CONDITION Are the roads [SL:ROAD_CONDITION slippery ] [SL:DATE_TIME this afternoon ] ]
Are the roads clear tonight?	Are the roads clear tonight ?	[IN:GET_INFO_ROAD_CONDITION Are the roads [SL:ROAD_CONDITION clear ] [SL:DATE_TIME tonight ] ? ]
Is Lowell Road in Hudson clear of snow this morning?	Is Lowell Road in Hudson clear of snow this morning ?	[IN:GET_INFO_ROAD_CONDITION Is [SL:LOCATION [IN:GET_LOCATION [SL:LOCATION Lowell Road ] in [SL:LOCATION_MODIFIER Hudson ] ] ] clear of [SL:ROAD_CONDITION snow ] [SL:DATE_TIME this morning ] ? ]
Is there flooding by the Marina?	Is there flooding by the Marina ?	[IN:GET_INFO_ROAD_CONDITION Is there [SL:ROAD_CONDITION flooding ] by [SL:LOCATION the Marina ] ? ]
What are the road conditions in Chicago	What are the road conditions in Chicago	[IN:GET_INFO_ROAD_CONDITION What are the road conditions in [SL:LOCATION Chicago ] ]
Is there snow on 243 heading toward Idyllwild?	Is there snow on 243 heading toward Idyllwild ?	[IN:GET_INFO_ROAD_CONDITION Is there [SL:ROAD_CONDITION snow ] on [SL:PATH 243 ] heading toward [SL:DESTINATION Idyllwild ] ? ]
Are there signs of snow on my way to mom's house?	Are there signs of snow on my way to mom 's house ?	[IN:GET_INFO_ROAD_CONDITION Are there signs of [SL:ROAD_CONDITION snow ] on my way to [SL:DESTINATION [IN:GET_LOCATION_HOME [SL:TYPE_RELATION mom ] 's house ] ] ? ]
What are the road conditions in Detroit	What are the road conditions in Detroit	[IN:GET_INFO_ROAD_CONDITION What are the road conditions in [SL:LOCATION Detroit ] ]
Any flooding on my route to the party tonight?	Any flooding on my route to the party tonight ?	[IN:GET_INFO_ROAD_CONDITION Any [SL:ROAD_CONDITION flooding ] on my route to [SL:DESTINATION [IN:GET_EVENT [SL:CATEGORY_EVENT the party ] [SL:DATE_TIME tonight ] ] ] ? ]
Is there any flooding on the roads this afternoon?	Is there any flooding on the roads this afternoon ?	[IN:GET_INFO_ROAD_CONDITION Is there [SL:ROAD_CONDITION any flooding ] on the roads [SL:DATE_TIME this afternoon ] ? ]
is I-20 still icy tonight	is I - 20 still icy tonight	[IN:GET_INFO_ROAD_CONDITION is [SL:LOCATION I - 20 ] still [SL:ROAD_CONDITION icy ] [SL:DATE_TIME tonight ] ]
How are the road conditions on Highway 78 this morning?	How are the road conditions on Highway 78 this morning ?	[IN:GET_INFO_ROAD_CONDITION How are the road conditions on [SL:LOCATION Highway 78 ] [SL:DATE_TIME this morning ] ? ]
Should I be worried about any flooded roads blocking me on my way to the Movie Theatre from home?	Should I be worried about any flooded roads blocking me on my way to the Movie Theatre from home ?	[IN:GET_INFO_ROAD_CONDITION Should I be worried about any [SL:ROAD_CONDITION flooded ] roads blocking me on my way to [SL:DESTINATION [IN:GET_LOCATION [SL:CATEGORY_LOCATION the Movie Theatre ] ] ] from [SL:SOURCE [IN:GET_LOCATION_HOME home ] ] ? ]
Is there any flooding conditions on my way to the football game downtown tomorrow morning?	Is there any flooding conditions on my way to the football game downtown tomorrow morning ?	[IN:GET_INFO_ROAD_CONDITION Is there any [SL:ROAD_CONDITION flooding conditions ] on my way to [SL:DESTINATION [IN:GET_EVENT [SL:CATEGORY_EVENT the football game ] [SL:LOCATION downtown ] [SL:DATE_TIME tomorrow morning ] ] ] ? ]
Can you tell me if there's fallen tree on the way to my brother's house now?	Can you tell me if there 's fallen tree on the way to my brother 's house now ?	[IN:GET_INFO_ROAD_CONDITION Can you tell me if there 's [SL:ROAD_CONDITION fallen tree ] on the way to [SL:DESTINATION [IN:GET_LOCATION_HOME [SL:CONTACT_RELATED my ] [SL:TYPE_RELATION brother ] 's house ] ] [SL:DATE_TIME now ] ? ]
is there snow in roads today ?	is there snow in roads today ?	[IN:GET_INFO_ROAD_CONDITION is there [SL:ROAD_CONDITION snow ] in roads [SL:DATE_TIME today ] ? ]
tell me what the road conditions are like	tell me what the road conditions are like	[IN:GET_INFO_ROAD_CONDITION tell me what the road conditions are like ]
What is the snow route near me	What is the snow route near me	[IN:GET_INFO_ROAD_CONDITION What is the [SL:ROAD_CONDITION snow ] route [SL:LOCATION [IN:GET_LOCATION [SL:SEARCH_RADIUS near ] [SL:LOCATION_USER me ] ] ] ]
I need to know if there are snowy roads for the route to the Peace Rally	I need to know if there are snowy roads for the route to the Peace Rally	[IN:GET_INFO_ROAD_CONDITION I need to know if there are [SL:ROAD_CONDITION snowy ] roads for the route to [SL:DESTINATION [IN:GET_EVENT [SL:CATEGORY_EVENT the Peace Rally ] ] ] ]
Are the travel conditions icy to get to Philadelphia today?	Are the travel conditions icy to get to Philadelphia today ?	[IN:GET_INFO_ROAD_CONDITION Are the travel conditions [SL:ROAD_CONDITION icy ] to get to [SL:DESTINATION Philadelphia ] [SL:DATE_TIME today ] ? ]
is there snow on the streets today?	is there snow on the streets today ?	[IN:GET_INFO_ROAD_CONDITION is there [SL:ROAD_CONDITION snow ] on the streets [SL:DATE_TIME today ] ? ]
have the roads from here to my mother's house been cleared of ice?	have the roads from here to my mother 's house been cleared of ice ?	[IN:GET_INFO_ROAD_CONDITION have the roads from [SL:SOURCE [IN:GET_LOCATION [SL:LOCATION_USER here ] ] ] to [SL:DESTINATION [IN:GET_LOCATION_HOME [SL:CONTACT_RELATED my ] [SL:TYPE_RELATION mother ] 's house ] ] been cleared of [SL:ROAD_CONDITION ice ] ? ]
Is my route to work icy right now?	Is my route to work icy right now ?	[IN:GET_INFO_ROAD_CONDITION Is my route to [SL:DESTINATION [IN:GET_LOCATION_WORK work ] ] [SL:ROAD_CONDITION icy ] [SL:DATE_TIME right now ] ? ]
Is there any flooding on my route to work	Is there any flooding on my route to work	[IN:GET_INFO_ROAD_CONDITION Is there any [SL:ROAD_CONDITION flooding ] on my route to [SL:DESTINATION [IN:GET_LOCATION_WORK work ] ] ]
I'm worried about flooding on Grand avenue, is it clear to go down Grand avenue out to highway 45?	I'm worried about flooding on Grand avenue , is it clear to go down Grand avenue out to highway 45 ?	[IN:GET_INFO_ROAD_CONDITION I'm worried about [SL:ROAD_CONDITION flooding ] on [SL:LOCATION Grand avenue ] , is it clear to go down Grand avenue out to [SL:DESTINATION highway 45 ] ? ]
are the roads snowy this morning?	are the roads snowy this morning ?	[IN:GET_INFO_ROAD_CONDITION are the roads [SL:ROAD_CONDITION snowy ] [SL:DATE_TIME this morning ] ? ]
Does the brush fire affect my drive	Does the brush fire affect my drive	[IN:GET_INFO_ROAD_CONDITION Does [SL:ROAD_CONDITION the brush fire ] affect my [SL:METHOD_TRAVEL drive ] ]
can the ice make the roads bad tonght for travel	can the ice make the roads bad tonght for travel	[IN:GET_INFO_ROAD_CONDITION can [SL:ROAD_CONDITION the ice ] make the roads bad [SL:DATE_TIME tonght ] for travel ]
How snowy are the roads that go to Toledo today	How snowy are the roads that go to Toledo today	[IN:GET_INFO_ROAD_CONDITION How [SL:ROAD_CONDITION snowy ] are the roads that go to [SL:DESTINATION Toledo ] [SL:DATE_TIME today ] ]
Were the roads brined for the snow/ice on Pleasant Hill Rd?	Were the roads brined for the snow / ice on Pleasant Hill Rd ?	[IN:GET_INFO_ROAD_CONDITION Were the roads [SL:ROAD_CONDITION brined for the snow / ice ] on [SL:LOCATION Pleasant Hill Rd ] ? ]
Will I run into flooding if I take a detour in the morning?	Will I run into flooding if I take a detour in the morning ?	[IN:GET_INFO_ROAD_CONDITION Will I run into [SL:ROAD_CONDITION flooding ] if I take a [SL:PATH detour ] [SL:DATE_TIME in the morning ] ? ]
Will the I5 south be icy in Tacoma?	Will the I5 south be icy in Tacoma ?	[IN:GET_INFO_ROAD_CONDITION Will [SL:PATH the I5 south ] be [SL:ROAD_CONDITION icy ] in [SL:LOCATION Tacoma ] ? ]
Do the roads get slippery in a thunderstorm near my home	Do the roads get slippery in a thunderstorm near my home	[IN:GET_INFO_ROAD_CONDITION Do the roads get [SL:ROAD_CONDITION slippery ] in a [SL:ROAD_CONDITION thunderstorm ] [SL:LOCATION [IN:GET_LOCATION [SL:SEARCH_RADIUS near ] [SL:LOCATION [IN:GET_LOCATION_HOME [SL:CONTACT my ] home ] ] ] ] ]
Are road conditions expected to delay large truck deliveries	Are road conditions expected to delay large truck deliveries	[IN:GET_INFO_ROAD_CONDITION Are road conditions expected to delay large truck deliveries ]
Is there ice on road in Fargo today	Is there ice on road in Fargo today	[IN:GET_INFO_ROAD_CONDITION Is there [SL:ROAD_CONDITION ice ] on road in [SL:LOCATION Fargo ] [SL:DATE_TIME today ] ]
What roads show flooding	What roads show flooding	[IN:GET_INFO_ROAD_CONDITION What roads show [SL:ROAD_CONDITION flooding ] ]
How is the rain going to be for my drive home	How is the rain going to be for my drive home	[IN:GET_INFO_ROAD_CONDITION How is [SL:ROAD_CONDITION the rain ] going to be for my [SL:METHOD_TRAVEL drive ] [SL:DESTINATION [IN:GET_LOCATION_HOME home ] ] ]
Are the roads near work icy?	Are the roads near work icy ?	[IN:GET_INFO_ROAD_CONDITION Are the roads [SL:LOCATION [IN:GET_LOCATION [SL:SEARCH_RADIUS near ] [SL:LOCATION [IN:GET_LOCATION_WORK work ] ] ] ] [SL:ROAD_CONDITION icy ] ? ]
Are there slippery roads this afternoon?	Are there slippery roads this afternoon ?	[IN:GET_INFO_ROAD_CONDITION Are there [SL:ROAD_CONDITION slippery ] roads [SL:DATE_TIME this afternoon ] ? ]
are the highways icy this morning	are the highways icy this morning	[IN:GET_INFO_ROAD_CONDITION are [SL:LOCATION [IN:GET_LOCATION [SL:CATEGORY_LOCATION the highways ] ] ] [SL:ROAD_CONDITION icy ] [SL:DATE_TIME this morning ] ]
Are the road conditions I see in northern Maine for this weekend	Are the road conditions I see in northern Maine for this weekend	[IN:GET_INFO_ROAD_CONDITION Are the road conditions I see in [SL:LOCATION [IN:GET_LOCATION [SL:LOCATION_MODIFIER northern ] [SL:LOCATION Maine ] ] ] for [SL:DATE_TIME this weekend ] ]
I want to know if the roads are slippery.	I want to know if the roads are slippery .	[IN:GET_INFO_ROAD_CONDITION I want to know if the roads are [SL:ROAD_CONDITION slippery ] . ]
are the roads still slippery this morning in Macomb	are the roads still slippery this morning in Macomb	[IN:GET_INFO_ROAD_CONDITION are the roads still [SL:ROAD_CONDITION slippery ] [SL:DATE_TIME this morning ] in [SL:LOCATION Macomb ] ]
Is there ice on the roads right now?	Is there ice on the roads right now ?	[IN:GET_INFO_ROAD_CONDITION Is there [SL:ROAD_CONDITION ice ] on the roads [SL:DATE_TIME right now ] ? ]
Are the roads near midtown still flooded?	Are the roads near midtown still flooded ?	[IN:GET_INFO_ROAD_CONDITION Are the roads [SL:LOCATION [IN:GET_LOCATION [SL:SEARCH_RADIUS near ] [SL:LOCATION midtown ] ] ] still [SL:ROAD_CONDITION flooded ] ? ]
Is there any flooding in Dewey?	Is there any flooding in Dewey ?	[IN:GET_INFO_ROAD_CONDITION Is there [SL:ROAD_CONDITION any flooding ] in [SL:LOCATION Dewey ] ? ]
Are the roads to Joe's house clear of snow?	Are the roads to Joe 's house clear of snow ?	[IN:GET_INFO_ROAD_CONDITION Are the roads to [SL:DESTINATION [IN:GET_LOCATION_HOME [SL:CONTACT Joe ] 's house ] ] clear of [SL:ROAD_CONDITION snow ] ? ]
Any icy roads to work today?	Any icy roads to work today ?	[IN:GET_INFO_ROAD_CONDITION Any [SL:ROAD_CONDITION icy ] roads to [SL:DESTINATION [IN:GET_LOCATION_WORK work ] ] [SL:DATE_TIME today ] ? ]
Is there flooding on the Lodge freeway right now?	Is there flooding on the Lodge freeway right now ?	[IN:GET_INFO_ROAD_CONDITION Is there [SL:ROAD_CONDITION flooding ] on [SL:LOCATION the Lodge freeway ] [SL:DATE_TIME right now ] ? ]
what are the current road conditions	what are the current road conditions	[IN:GET_INFO_ROAD_CONDITION what are the current road conditions ]
Did the rain affect driving to my uncle Safwat?	Did the rain affect driving to my uncle Safwat ?	[IN:GET_INFO_ROAD_CONDITION Did [SL:ROAD_CONDITION the rain ] affect [SL:METHOD_TRAVEL driving ] to [SL:DESTINATION [IN:GET_LOCATION_HOME [SL:CONTACT_RELATED my ] [SL:TYPE_RELATION uncle ] [SL:CONTACT Safwat ] ] ] ? ]
Are the roads slick this morning?	Are the roads slick this morning ?	[IN:GET_INFO_ROAD_CONDITION Are the roads [SL:ROAD_CONDITION slick ] [SL:DATE_TIME this morning ] ? ]
We got a lot of snow last night is Holmes County under any traffic emergencies right now	We got a lot of snow last night is Holmes County under any traffic emergencies right now	[IN:GET_INFO_ROAD_CONDITION We got a lot of [SL:ROAD_CONDITION snow ] last night is [SL:LOCATION Holmes County ] under any traffic emergencies [SL:DATE_TIME right now ] ]
Are the roads to Jill's house cover in snow?	Are the roads to Jill 's house cover in snow ?	[IN:GET_INFO_ROAD_CONDITION Are the roads to [SL:DESTINATION [IN:GET_LOCATION_HOME [SL:CONTACT Jill ] 's house ] ] cover in [SL:ROAD_CONDITION snow ] ? ]
Are the airlines shut down due to weather	Are the airlines shut down due to weather	[IN:GET_INFO_ROAD_CONDITION Are the [SL:METHOD_TRAVEL airlines ] shut down due to [SL:ROAD_CONDITION weather ] ]
Are the streets to Jim's house flooded?	Are the streets to Jim 's house flooded ?	[IN:GET_INFO_ROAD_CONDITION Are the streets to [SL:DESTINATION [IN:GET_LOCATION_HOME [SL:CONTACT Jim ] 's house ] ] [SL:ROAD_CONDITION flooded ] ? ]
did the road flooded yesterday morning?	did the road flooded yesterday morning ?	[IN:GET_INFO_ROAD_CONDITION did the road [SL:ROAD_CONDITION flooded ] [SL:DATE_TIME yesterday morning ] ? ]
How is the snow level on Fifth Avenue?	How is the snow level on Fifth Avenue ?	[IN:GET_INFO_ROAD_CONDITION How is [SL:ROAD_CONDITION the snow level ] on [SL:LOCATION Fifth Avenue ] ? ]
Are there any rain warnings	Are there any rain warnings	[IN:GET_INFO_ROAD_CONDITION Are there any [SL:ROAD_CONDITION rain ] warnings ]
Are the roads slippery from last night's rainfall?	Are the roads slippery from last night 's rainfall ?	[IN:GET_INFO_ROAD_CONDITION Are the roads [SL:ROAD_CONDITION slippery ] from last night 's rainfall ? ]
what is the road conditions on the I-95?	what is the road conditions on the I - 95 ?	[IN:GET_INFO_ROAD_CONDITION what is [SL:ROAD_CONDITION the road conditions ] on [SL:LOCATION the I - 95 ] ? ]
It's snowing. How are road conditions for my morning commute	It 's snowing . How are road conditions for my morning commute	[IN:GET_INFO_ROAD_CONDITION It 's [SL:ROAD_CONDITION snowing ] . How are road conditions for my [SL:DATE_TIME morning ] [SL:PATH commute ] ]
Are there any ice on Giza road 5.45 am?	Are there any ice on Giza road 5.45 am ?	[IN:GET_INFO_ROAD_CONDITION Are there any [SL:ROAD_CONDITION ice ] on [SL:LOCATION Giza road ] [SL:DATE_TIME 5.45 am ] ? ]
Are the roads to my office plowed yet	Are the roads to my office plowed yet	[IN:GET_INFO_ROAD_CONDITION Are the roads to [SL:DESTINATION [IN:GET_LOCATION_WORK [SL:CONTACT my ] office ] ] [SL:ROAD_CONDITION plowed ] yet ]
Will the snow slow me down if I take Route 9 to work?	Will the snow slow me down if I take Route 9 to work ?	[IN:GET_INFO_ROAD_CONDITION Will [SL:ROAD_CONDITION the snow ] slow me down if I take [SL:PATH Route 9 ] to [SL:DESTINATION [IN:GET_LOCATION_WORK work ] ] ? ]
We have got a lot of rain are there any local roads closed because of it.	We have got a lot of rain are there any local roads closed because of it .	[IN:GET_INFO_ROAD_CONDITION We have got a lot of [SL:ROAD_CONDITION rain ] are there any local roads closed because of it . ]
Are the roads slippery this morning?	Are the roads slippery this morning ?	[IN:GET_INFO_ROAD_CONDITION Are the roads [SL:ROAD_CONDITION slippery ] [SL:DATE_TIME this morning ] ? ]
How are the road conditions on the way to Celia's house?	How are the road conditions on the way to Celia 's house ?	[IN:GET_INFO_ROAD_CONDITION How are the road conditions on the way to [SL:DESTINATION [IN:GET_LOCATION_HOME [SL:CONTACT Celia ] 's house ] ] ? ]
Will it be icy on my way to work in the morning?	Will it be icy on my way to work in the morning ?	[IN:GET_INFO_ROAD_CONDITION Will it be [SL:ROAD_CONDITION icy ] on my way to [SL:DESTINATION [IN:GET_LOCATION_WORK work ] ] [SL:DATE_TIME in the morning ] ? ]
have the roads been plowed yet	have the roads been plowed yet	[IN:GET_INFO_ROAD_CONDITION have the roads been [SL:ROAD_CONDITION plowed ] yet ]
can I drive the bike in Fort Collins this morning due to the road conditions	can I drive the bike in Fort Collins this morning due to the road conditions	[IN:GET_INFO_ROAD_CONDITION can I drive the [SL:METHOD_TRAVEL bike ] in [SL:LOCATION Fort Collins ] [SL:DATE_TIME this morning ] due to the road conditions ]
Are there icy conditions on the road between Seattle and Eugene, Oregon?	Are there icy conditions on the road between Seattle and Eugene , Oregon ?	[IN:GET_INFO_ROAD_CONDITION Are there [SL:ROAD_CONDITION icy ] conditions on the road between [SL:SOURCE Seattle ] and [SL:DESTINATION Eugene , Oregon ] ? ]
Will I run into snow on the roads on my way to the republican convention?	Will I run into snow on the roads on my way to the republican convention ?	[IN:GET_INFO_ROAD_CONDITION Will I run into [SL:ROAD_CONDITION snow ] on the roads on my way to [SL:DESTINATION [IN:GET_EVENT [SL:CATEGORY_EVENT the republican convention ] ] ] ? ]
ARE ALL THE SNOW CLEARED FROM THE FREEWAYS FOR MY MORNING COMMUTE TO WORK THIS MORNING	ARE ALL THE SNOW CLEARED FROM THE FREEWAYS FOR MY MORNING COMMUTE TO WORK THIS MORNING	[IN:GET_INFO_ROAD_CONDITION ARE ALL [SL:ROAD_CONDITION THE SNOW ] CLEARED FROM [SL:LOCATION [IN:GET_LOCATION [SL:CATEGORY_LOCATION THE FREEWAYS ] ] ] FOR [SL:PATH MY MORNING COMMUTE ] TO [SL:DESTINATION [IN:GET_LOCATION_WORK WORK ] ] [SL:DATE_TIME_DEPARTURE THIS MORNING ] ]
Are the roads icy on my way home tonight?	Are the roads icy on my way home tonight ?	[IN:GET_INFO_ROAD_CONDITION Are the roads [SL:ROAD_CONDITION icy ] on my way [SL:DESTINATION [IN:GET_LOCATION_HOME home ] ] [SL:DATE_TIME tonight ] ? ]
Is Ash Street snow packed or did they clear it?	Is Ash Street snow packed or did they clear it ?	[IN:GET_INFO_ROAD_CONDITION Is [SL:LOCATION Ash Street ] [SL:ROAD_CONDITION snow packed ] or did they clear it ? ]
Will the roads in savannah be foggy tonight	Will the roads in savannah be foggy tonight	[IN:GET_INFO_ROAD_CONDITION Will the roads in [SL:LOCATION savannah ] be [SL:ROAD_CONDITION foggy ] [SL:DATE_TIME tonight ] ]
Are the roads cleared of snow today	Are the roads cleared of snow today	[IN:GET_INFO_ROAD_CONDITION Are the roads cleared of [SL:ROAD_CONDITION snow ] [SL:DATE_TIME today ] ]
Are the any icy road conditions on I 77 this morning	Are the any icy road conditions on I 77 this morning	[IN:GET_INFO_ROAD_CONDITION Are the any [SL:ROAD_CONDITION icy ] road conditions on [SL:LOCATION I 77 ] [SL:DATE_TIME this morning ] ]
Are the roads slippery this afternoon?	Are the roads slippery this afternoon ?	[IN:GET_INFO_ROAD_CONDITION Are the roads [SL:ROAD_CONDITION slippery ] [SL:DATE_TIME this afternoon ] ? ]
what are the driving conditions today for the NSP	what are the driving conditions today for the NSP	[IN:GET_INFO_ROAD_CONDITION what are the [SL:METHOD_TRAVEL driving ] conditions [SL:DATE_TIME today ] for [SL:LOCATION the NSP ] ]
is there snow on the roads this morning	is there snow on the roads this morning	[IN:GET_INFO_ROAD_CONDITION is there [SL:ROAD_CONDITION snow ] on the roads [SL:DATE_TIME this morning ] ]
Is there a snow advisory for driving conditions	Is there a snow advisory for driving conditions	[IN:GET_INFO_ROAD_CONDITION Is there a [SL:ROAD_CONDITION snow ] advisory for [SL:METHOD_TRAVEL driving ] conditions ]
Has highway 76 been cleared yet?	Has highway 76 been cleared yet ?	[IN:GET_INFO_ROAD_CONDITION Has [SL:LOCATION highway 76 ] been [SL:ROAD_CONDITION cleared ] yet ? ]
Are the roads icy on the way to my brother's house?	Are the roads icy on the way to my brother 's house ?	[IN:GET_INFO_ROAD_CONDITION Are the roads [SL:ROAD_CONDITION icy ] on the way to [SL:DESTINATION [IN:GET_LOCATION_HOME [SL:CONTACT_RELATED my ] [SL:TYPE_RELATION brother ] 's house ] ] ? ]
will the roads be wet on my evening commute on route 5	will the roads be wet on my evening commute on route 5	[IN:GET_INFO_ROAD_CONDITION will the roads be [SL:ROAD_CONDITION wet ] on [SL:PATH my evening commute ] on [SL:LOCATION route 5 ] ]
Are any of the roads in town flooded today?	Are any of the roads in town flooded today ?	[IN:GET_INFO_ROAD_CONDITION Are any of the roads in [SL:LOCATION town ] [SL:ROAD_CONDITION flooded ] [SL:DATE_TIME today ] ? ]
Any snow alert before noon in Jersey city	Any snow alert before noon in Jersey city	[IN:GET_INFO_ROAD_CONDITION Any [SL:ROAD_CONDITION snow alert ] [SL:DATE_TIME before noon ] in [SL:LOCATION Jersey city ] ]
are there any icy roads?	are there any icy roads ?	[IN:GET_INFO_ROAD_CONDITION are there any [SL:ROAD_CONDITION icy ] roads ? ]
Tell me the roads aren't slippery going to the theatre this evening.	Tell me the roads aren't slippery going to the theatre this evening .	[IN:GET_INFO_ROAD_CONDITION Tell me the roads aren't [SL:ROAD_CONDITION slippery ] going to [SL:DESTINATION [IN:GET_LOCATION [SL:CATEGORY_LOCATION the theatre ] ] ] [SL:DATE_TIME_DEPARTURE this evening ] . ]
Are the roads wet on the way to hunting island	Are the roads wet on the way to hunting island	[IN:GET_INFO_ROAD_CONDITION Are the roads [SL:ROAD_CONDITION wet ] on the way to [SL:DESTINATION hunting island ] ]
Are the roads icy this morning going to Garrett's house?	Are the roads icy this morning going to Garrett 's house ?	[IN:GET_INFO_ROAD_CONDITION Are the roads [SL:ROAD_CONDITION icy ] [SL:DATE_TIME this morning ] going to [SL:DESTINATION [IN:GET_LOCATION_HOME [SL:CONTACT Garrett ] 's house ] ] ? ]
Are the roads to the Falcons game still icy this morning?	Are the roads to the Falcons game still icy this morning ?	[IN:GET_INFO_ROAD_CONDITION Are the roads to [SL:DESTINATION [IN:GET_EVENT the [SL:NAME_EVENT Falcons ] [SL:CATEGORY_EVENT game ] ] ] still [SL:ROAD_CONDITION icy ] [SL:DATE_TIME this morning ] ? ]
What are road conditions for tomorrow on Alabama city	What are road conditions for tomorrow on Alabama city	[IN:GET_INFO_ROAD_CONDITION What are road conditions [SL:DATE_TIME for tomorrow ] on [SL:LOCATION Alabama city ] ]
Are there any flooding in the belt parkway?	Are there any flooding in the belt parkway ?	[IN:GET_INFO_ROAD_CONDITION Are there any [SL:ROAD_CONDITION flooding ] in [SL:LOCATION the belt parkway ] ? ]
will the interstate still be flooded at 9?	will the interstate still be flooded at 9 ?	[IN:GET_INFO_ROAD_CONDITION will [SL:LOCATION [IN:GET_LOCATION [SL:CATEGORY_LOCATION the interstate ] ] ] still be [SL:ROAD_CONDITION flooded ] [SL:DATE_TIME at 9 ] ? ]
Are the roads cleared of snow on Mill Street?	Are the roads cleared of snow on Mill Street ?	[IN:GET_INFO_ROAD_CONDITION Are the roads cleared of [SL:ROAD_CONDITION snow ] on [SL:LOCATION Mill Street ] ? ]
Are there any icy patches on the way to Toronto?	Are there any icy patches on the way to Toronto ?	[IN:GET_INFO_ROAD_CONDITION Are there any [SL:ROAD_CONDITION icy patches ] on the way to [SL:DESTINATION Toronto ] ? ]
How are road conditions	How are road conditions	[IN:GET_INFO_ROAD_CONDITION How are road conditions ]
How are the road conditions in Cleveland	How are the road conditions in Cleveland	[IN:GET_INFO_ROAD_CONDITION How are the road conditions in [SL:LOCATION Cleveland ] ]
Are the roads flooded this afternoon?	Are the roads flooded this afternoon ?	[IN:GET_INFO_ROAD_CONDITION Are the roads [SL:ROAD_CONDITION flooded ] [SL:DATE_TIME this afternoon ] ? ]
Are there ice or snow on my way to work now?	Are there ice or snow on my way to work now ?	[IN:GET_INFO_ROAD_CONDITION Are there [SL:ROAD_CONDITION ice ] or [SL:ROAD_CONDITION snow ] on my way to [SL:DESTINATION [IN:GET_LOCATION_WORK work ] ] [SL:DATE_TIME_DEPARTURE now ] ? ]
Are the roads to Maher's house icy?	Are the roads to Maher 's house icy ?	[IN:GET_INFO_ROAD_CONDITION Are the roads to [SL:DESTINATION [IN:GET_LOCATION_HOME [SL:CONTACT Maher ] 's house ] ] [SL:ROAD_CONDITION icy ] ? ]
is there snow on the way to Big Bear now	is there snow on the way to Big Bear now	[IN:GET_INFO_ROAD_CONDITION is there [SL:ROAD_CONDITION snow ] on the way to [SL:DESTINATION Big Bear ] [SL:DATE_TIME now ] ]
What are the road conditions like going to my mother's house passed my aunt's on 54th Street in Big Stone Gap Virginia	What are the road conditions like going to my mother 's house passed my aunt 's on 54th Street in Big Stone Gap Virginia	[IN:GET_INFO_ROAD_CONDITION What are the road conditions like going to [SL:DESTINATION [IN:GET_LOCATION_HOME [SL:CONTACT_RELATED my ] [SL:TYPE_RELATION mother ] 's house ] ] passed [SL:WAYPOINT [IN:GET_LOCATION_HOME [SL:CONTACT_RELATED my ] [SL:TYPE_RELATION aunt ] 's on [SL:LOCATION [IN:GET_LOCATION [SL:LOCATION_MODIFIER 54th Street ] ] ] in [SL:LOCATION [IN:GET_LOCATION [SL:LOCATION_MODIFIER Big Stone Gap Virginia ] ] ] ] ] ]
have they opened the 101 since the fires	have they opened the 101 since the fires	[IN:GET_INFO_ROAD_CONDITION have they opened [SL:LOCATION the 101 ] since [SL:ROAD_CONDITION the fires ] ]
Are the roads plowed this morning	Are the roads plowed this morning	[IN:GET_INFO_ROAD_CONDITION Are the roads [SL:ROAD_CONDITION plowed ] [SL:DATE_TIME this morning ] ]
Did they clear the snow on the main road to Livingston Center?	Did they clear the snow on the main road to Livingston Center ?	[IN:GET_INFO_ROAD_CONDITION Did they clear [SL:ROAD_CONDITION the snow ] on [SL:PATH the main road ] to [SL:DESTINATION [IN:GET_LOCATION [SL:POINT_ON_MAP Livingston Center ] ] ] ? ]
are the roads icy on the way to Kim's tonight?	are the roads icy on the way to Kim 's tonight ?	[IN:GET_INFO_ROAD_CONDITION are the roads [SL:ROAD_CONDITION icy ] on the way to [SL:DESTINATION [IN:GET_LOCATION_HOME [SL:CONTACT Kim ] 's ] ] [SL:DATE_TIME_DEPARTURE tonight ] ? ]
is highway 603 icy	is highway 603 icy	[IN:GET_INFO_ROAD_CONDITION is [SL:LOCATION highway 603 ] [SL:ROAD_CONDITION icy ] ]
can i expect black ice conditions on the roads tonight?	can i expect black ice conditions on the roads tonight ?	[IN:GET_INFO_ROAD_CONDITION can i expect [SL:ROAD_CONDITION black ice ] conditions on the roads [SL:DATE_TIME tonight ] ? ]
Are the roads flooded	Are the roads flooded	[IN:GET_INFO_ROAD_CONDITION Are the roads [SL:ROAD_CONDITION flooded ] ]
Is there a flooding in Boulder Highway?	Is there a flooding in Boulder Highway ?	[IN:GET_INFO_ROAD_CONDITION Is there a [SL:ROAD_CONDITION flooding ] in [SL:LOCATION Boulder Highway ] ? ]
Will the rain in the morning affect the traffic	Will the rain in the morning affect the traffic	[IN:GET_INFO_ROAD_CONDITION Will [SL:ROAD_CONDITION the rain ] [SL:DATE_TIME in the morning ] affect the traffic ]
will the roads be icy tonight going to mom's house	will the roads be icy tonight going to mom 's house	[IN:GET_INFO_ROAD_CONDITION will the roads be [SL:ROAD_CONDITION icy ] [SL:DATE_TIME tonight ] going to [SL:DESTINATION [IN:GET_LOCATION_HOME [SL:TYPE_RELATION mom ] 's house ] ] ]
What are the road conditions near the downtown bank tonight?	What are the road conditions near the downtown bank tonight ?	[IN:GET_INFO_ROAD_CONDITION What are the road conditions [SL:LOCATION [IN:GET_LOCATION [SL:SEARCH_RADIUS near ] the [SL:LOCATION_MODIFIER downtown ] [SL:CATEGORY_LOCATION bank ] ] ] [SL:DATE_TIME tonight ] ? ]
is there flooding on the 37 now	is there flooding on the 37 now	[IN:GET_INFO_ROAD_CONDITION is there [SL:ROAD_CONDITION flooding ] on [SL:LOCATION the 37 ] [SL:DATE_TIME now ] ]
is there any flooding on the way to uncle's house in nasr city?	is there any flooding on the way to uncle 's house in nasr city ?	[IN:GET_INFO_ROAD_CONDITION is there any [SL:ROAD_CONDITION flooding ] on the way to [SL:DESTINATION [IN:GET_LOCATION_HOME [SL:TYPE_RELATION uncle ] 's house in [SL:LOCATION [IN:GET_LOCATION [SL:LOCATION_MODIFIER nasr city ] ] ] ] ] ? ]
Is the snow blocking route 5	Is the snow blocking route 5	[IN:GET_INFO_ROAD_CONDITION Is [SL:ROAD_CONDITION the snow ] blocking [SL:LOCATION route 5 ] ]
If I leave my house at 7 AM do rain could affect my road to  Jazz Music Festival in Nasr City?	If I leave my house at 7 AM do rain could affect my road to Jazz Music Festival in Nasr City ?	[IN:GET_INFO_ROAD_CONDITION If I leave [SL:SOURCE [IN:GET_LOCATION_HOME [SL:CONTACT my ] house ] ] [SL:DATE_TIME_DEPARTURE at 7 AM ] do [SL:ROAD_CONDITION rain ] could affect my road to [SL:DESTINATION [IN:GET_EVENT [SL:CATEGORY_EVENT Jazz Music Festival ] in [SL:LOCATION Nasr City ] ] ] ? ]
are the roads snowy in pewaukee	are the roads snowy in pewaukee	[IN:GET_INFO_ROAD_CONDITION are the roads [SL:ROAD_CONDITION snowy ] in [SL:LOCATION pewaukee ] ]
What are the road conditions going to Warroad tonight?	What are the road conditions going to Warroad tonight ?	[IN:GET_INFO_ROAD_CONDITION What are the road conditions going to [SL:DESTINATION Warroad ] [SL:DATE_TIME tonight ] ? ]
Are the roads icy on route 10 right now	Are the roads icy on route 10 right now	[IN:GET_INFO_ROAD_CONDITION Are the roads [SL:ROAD_CONDITION icy ] on [SL:LOCATION route 10 ] [SL:DATE_TIME right now ] ]
are any road condition on grape vein tonight	are any road condition on grape vein tonight	[IN:GET_INFO_ROAD_CONDITION are any [SL:ROAD_CONDITION road condition ] on [SL:LOCATION grape vein ] [SL:DATE_TIME tonight ] ]
Are the roads slick	Are the roads slick	[IN:GET_INFO_ROAD_CONDITION Are the roads [SL:ROAD_CONDITION slick ] ]
Is I-70 slick from mile marker 254 to 257?	Is I - 70 slick from mile marker 254 to 257 ?	[IN:GET_INFO_ROAD_CONDITION Is [SL:PATH I - 70 ] [SL:ROAD_CONDITION slick ] from [SL:SOURCE [IN:GET_LOCATION [SL:POINT_ON_MAP mile marker 254 ] ] ] to [SL:DESTINATION [IN:GET_LOCATION [SL:POINT_ON_MAP 257 ] ] ] ? ]
Are there icy roads in Atlanta tonight?	Are there icy roads in Atlanta tonight ?	[IN:GET_INFO_ROAD_CONDITION Are there [SL:ROAD_CONDITION icy ] roads in [SL:LOCATION Atlanta ] [SL:DATE_TIME tonight ] ? ]
Road report for ice going to Bemidji.	Road report for ice going to Bemidji .	[IN:GET_INFO_ROAD_CONDITION Road report for [SL:ROAD_CONDITION ice ] going to [SL:DESTINATION Bemidji ] . ]
Is there any ice on the road between here and the concert I'm going to?	Is there any ice on the road between here and the concert I'm going to ?	[IN:GET_INFO_ROAD_CONDITION Is there any [SL:ROAD_CONDITION ice ] on the road between [SL:SOURCE [IN:GET_LOCATION [SL:LOCATION_USER here ] ] ] and [SL:DESTINATION [IN:GET_EVENT [SL:CATEGORY_EVENT the concert ] ] ] I'm going to ? ]
Is there flooding on the New Jersey Turnpike South heading towards Philadelphia today?	Is there flooding on the New Jersey Turnpike South heading towards Philadelphia today ?	[IN:GET_INFO_ROAD_CONDITION Is there [SL:ROAD_CONDITION flooding ] on [SL:PATH the New Jersey Turnpike South ] heading towards [SL:DESTINATION Philadelphia ] [SL:DATE_TIME today ] ? ]
Is there flooding on 5th Avenue driving down to Battery Park?	Is there flooding on 5th Avenue driving down to Battery Park ?	[IN:GET_INFO_ROAD_CONDITION Is there [SL:ROAD_CONDITION flooding ] on [SL:PATH 5th Avenue ] [SL:METHOD_TRAVEL driving ] down to [SL:DESTINATION [IN:GET_LOCATION [SL:POINT_ON_MAP Battery Park ] ] ] ? ]
are the roads icy	are the roads icy	[IN:GET_INFO_ROAD_CONDITION are the roads [SL:ROAD_CONDITION icy ] ]
Is there snow expected on my route to the concert this Sunday?	Is there snow expected on my route to the concert this Sunday ?	[IN:GET_INFO_ROAD_CONDITION Is there [SL:ROAD_CONDITION snow ] expected on my route to [SL:DESTINATION [IN:GET_EVENT [SL:CATEGORY_EVENT the concert ] [SL:DATE_TIME this Sunday ] ] ] ? ]
Is there any flooding on my route home?	Is there any flooding on my route home ?	[IN:GET_INFO_ROAD_CONDITION Is there [SL:ROAD_CONDITION any flooding ] on my route [SL:DESTINATION [IN:GET_LOCATION_HOME home ] ] ? ]
Road conditions updates	Road conditions updates	[IN:GET_INFO_ROAD_CONDITION Road conditions updates ]
Are the roads flooded tonight on Baker Street?	Are the roads flooded tonight on Baker Street ?	[IN:GET_INFO_ROAD_CONDITION Are the roads [SL:ROAD_CONDITION flooded ] [SL:DATE_TIME tonight ] on [SL:LOCATION Baker Street ] ? ]
Is Desert Inn Road icy?	Is Desert Inn Road icy ?	[IN:GET_INFO_ROAD_CONDITION Is [SL:LOCATION Desert Inn Road ] [SL:ROAD_CONDITION icy ] ? ]
Please let me know if there is ice and snow on my route to the farmer's market	Please let me know if there is ice and snow on my route to the farmer 's market	[IN:GET_INFO_ROAD_CONDITION Please let me know if there is [SL:ROAD_CONDITION ice ] and [SL:ROAD_CONDITION snow ] on my route to [SL:DESTINATION [IN:GET_EVENT [SL:CATEGORY_EVENT the farmer 's market ] ] ] ]
Is there any flooding on the way to Delta Park from my house?	Is there any flooding on the way to Delta Park from my house ?	[IN:GET_INFO_ROAD_CONDITION Is there any [SL:ROAD_CONDITION flooding ] on the way to [SL:DESTINATION [IN:GET_LOCATION [SL:POINT_ON_MAP Delta Park ] ] ] from [SL:SOURCE [IN:GET_LOCATION_HOME [SL:CONTACT my ] house ] ] ? ]
what are the road conditions this evening	what are the road conditions this evening	[IN:GET_INFO_ROAD_CONDITION what are the road conditions [SL:DATE_TIME this evening ] ]
Is there any flooding on Greenridge street today?	Is there any flooding on Greenridge street today ?	[IN:GET_INFO_ROAD_CONDITION Is there [SL:ROAD_CONDITION any flooding ] on [SL:LOCATION Greenridge street ] [SL:DATE_TIME today ] ? ]
Are the roads icy on the way to my afternoon meeting?	Are the roads icy on the way to my afternoon meeting ?	[IN:GET_INFO_ROAD_CONDITION Are the roads [SL:ROAD_CONDITION icy ] on the way to [SL:DESTINATION [IN:GET_EVENT [SL:ATTENDEE_EVENT my ] [SL:DATE_TIME afternoon ] [SL:CATEGORY_EVENT meeting ] ] ] ? ]
will the icy roads between  the bronx and hoboken be cleared if I live in an hour	will the icy roads between the bronx and hoboken be cleared if I live in an hour	[IN:GET_INFO_ROAD_CONDITION will the [SL:ROAD_CONDITION icy ] roads between [SL:SOURCE the bronx ] and [SL:DESTINATION hoboken ] be cleared if I live [SL:DATE_TIME_DEPARTURE in an hour ] ]
Is the bridge still out on the Northbound lane of Hwy 331	Is the bridge still out on the Northbound lane of Hwy 331	[IN:GET_INFO_ROAD_CONDITION Is [SL:PATH the bridge ] still [SL:ROAD_CONDITION out ] on [SL:LOCATION [IN:GET_LOCATION [SL:LOCATION_MODIFIER the Northbound lane ] of [SL:LOCATION Hwy 331 ] ] ] ]
Are the roads leading to Walmart safe to drive on?	Are the roads leading to Walmart safe to drive on ?	[IN:GET_INFO_ROAD_CONDITION Are the roads leading to [SL:DESTINATION Walmart ] safe to [SL:METHOD_TRAVEL drive ] on ? ]
Are the roads icy this morning	Are the roads icy this morning	[IN:GET_INFO_ROAD_CONDITION Are the roads [SL:ROAD_CONDITION icy ] [SL:DATE_TIME this morning ] ]
Are road conditions slick between here and the gym	Are road conditions slick between here and the gym	[IN:GET_INFO_ROAD_CONDITION Are road conditions [SL:ROAD_CONDITION slick ] between [SL:SOURCE [IN:GET_LOCATION [SL:LOCATION_USER here ] ] ] and [SL:DESTINATION [IN:GET_LOCATION [SL:CATEGORY_LOCATION the gym ] ] ] ]
will I need chains on Sunday	will I need chains on Sunday	[IN:GET_INFO_ROAD_CONDITION will I need chains [SL:DATE_TIME on Sunday ] ]
is there icy roads on 1-75 this morning	is there icy roads on 1 - 75 this morning	[IN:GET_INFO_ROAD_CONDITION is there [SL:ROAD_CONDITION icy ] roads on [SL:LOCATION 1 - 75 ] [SL:DATE_TIME this morning ] ]
Are there any flooding on my way to dad's house right now?	Are there any flooding on my way to dad 's house right now ?	[IN:GET_INFO_ROAD_CONDITION Are there any [SL:ROAD_CONDITION flooding ] on my way to [SL:DESTINATION [IN:GET_LOCATION_HOME [SL:TYPE_RELATION dad ] 's house ] ] [SL:DATE_TIME right now ] ? ]
Any roads flooded today	Any roads flooded today	[IN:GET_INFO_ROAD_CONDITION Any roads [SL:ROAD_CONDITION flooded ] [SL:DATE_TIME today ] ]
What are the road conditions	What are the road conditions	[IN:GET_INFO_ROAD_CONDITION What are the road conditions ]
is the snow clear on Stark St	is the snow clear on Stark St	[IN:GET_INFO_ROAD_CONDITION is [SL:ROAD_CONDITION the snow ] clear on [SL:LOCATION Stark St ] ]
Are the roads icy this morning ?	Are the roads icy this morning ?	[IN:GET_INFO_ROAD_CONDITION Are the roads [SL:ROAD_CONDITION icy ] [SL:DATE_TIME this morning ] ? ]
Are there any expected rain in my way to Ramses square by 10 PM?	Are there any expected rain in my way to Ramses square by 10 PM ?	[IN:GET_INFO_ROAD_CONDITION Are there any expected [SL:ROAD_CONDITION rain ] in my way to [SL:DESTINATION [IN:GET_LOCATION [SL:POINT_ON_MAP Ramses square ] ] ] [SL:DATE_TIME_ARRIVAL by 10 PM ] ? ]
How much snow fell on the roads lastnight	How much snow fell on the roads lastnight	[IN:GET_INFO_ROAD_CONDITION How much [SL:ROAD_CONDITION snow ] fell on the roads [SL:DATE_TIME lastnight ] ]
Has the rain caused any flooding on my route home?	Has the rain caused any flooding on my route home ?	[IN:GET_INFO_ROAD_CONDITION Has the rain caused any [SL:ROAD_CONDITION flooding ] on my route [SL:DESTINATION [IN:GET_LOCATION_HOME home ] ] ? ]
Are the roads icy right now?	Are the roads icy right now ?	[IN:GET_INFO_ROAD_CONDITION Are the roads [SL:ROAD_CONDITION icy ] [SL:DATE_TIME right now ] ? ]
is the weather bad going to the park	is the weather bad going to the park	[IN:GET_INFO_ROAD_CONDITION is the weather bad going to [SL:DESTINATION [IN:GET_LOCATION [SL:CATEGORY_LOCATION the park ] ] ] ]
Is the road to Diana's icy right now?	Is the road to Diana 's icy right now ?	[IN:GET_INFO_ROAD_CONDITION Is the road to [SL:DESTINATION [IN:GET_LOCATION_HOME [SL:CONTACT Diana ] ] ] 's [SL:ROAD_CONDITION icy ] [SL:DATE_TIME right now ] ? ]
Will it be icy on the roads tomorrow to get to the poconos from my house?	Will it be icy on the roads tomorrow to get to the poconos from my house ?	[IN:GET_INFO_ROAD_CONDITION Will it be [SL:ROAD_CONDITION icy ] on the roads [SL:DATE_TIME tomorrow ] to get to [SL:DESTINATION the poconos ] from [SL:SOURCE [IN:GET_LOCATION_HOME [SL:CONTACT my ] house ] ] ? ]
How are road conditions right now from my house to Bert's house?	How are road conditions right now from my house to Bert 's house ?	[IN:GET_INFO_ROAD_CONDITION How are road conditions [SL:DATE_TIME right now ] from [SL:SOURCE [IN:GET_LOCATION_HOME [SL:CONTACT my ] house ] ] to [SL:DESTINATION [IN:GET_LOCATION_HOME [SL:CONTACT Bert ] 's house ] ] ? ]
Has the snow been cleared at Lone Oak Road in Minnesota?	Has the snow been cleared at Lone Oak Road in Minnesota ?	[IN:GET_INFO_ROAD_CONDITION Has [SL:ROAD_CONDITION the snow ] been cleared at [SL:LOCATION [IN:GET_LOCATION [SL:LOCATION Lone Oak Road ] in [SL:LOCATION_MODIFIER Minnesota ] ] ] ? ]
I'd like to know if the roads are clear on my way home tonight	I'd like to know if the roads are clear on my way home tonight	[IN:GET_INFO_ROAD_CONDITION I'd like to know if the roads are [SL:ROAD_CONDITION clear ] on my way [SL:DESTINATION [IN:GET_LOCATION_HOME home ] ] [SL:DATE_TIME tonight ] ]
Is the fog thick this morning?	Is the fog thick this morning ?	[IN:GET_INFO_ROAD_CONDITION Is [SL:ROAD_CONDITION the fog ] thick [SL:DATE_TIME this morning ] ? ]
Will I run into flooding on my way to the Miami Heat game?	Will I run into flooding on my way to the Miami Heat game ?	[IN:GET_INFO_ROAD_CONDITION Will I run into [SL:ROAD_CONDITION flooding ] on my way to [SL:DESTINATION [IN:GET_EVENT the [SL:NAME_EVENT Miami Heat ] [SL:CATEGORY_EVENT game ] ] ] ? ]
Will I run into ice and Snow tomorrow on my way to the Wrestling meet?	Will I run into ice and Snow tomorrow on my way to the Wrestling meet ?	[IN:GET_INFO_ROAD_CONDITION Will I run into [SL:ROAD_CONDITION ice ] and [SL:ROAD_CONDITION Snow ] [SL:DATE_TIME_DEPARTURE tomorrow ] on my way to [SL:DESTINATION [IN:GET_EVENT [SL:CATEGORY_EVENT the Wrestling meet ] ] ] ? ]
Are the roads to Alexis's house clear?	Are the roads to Alexis 's house clear ?	[IN:GET_INFO_ROAD_CONDITION Are the roads to [SL:DESTINATION [IN:GET_LOCATION_HOME [SL:CONTACT Alexis ] 's house ] ] [SL:ROAD_CONDITION clear ] ? ]
Is there a snow storm blocking roads in Placerville	Is there a snow storm blocking roads in Placerville	[IN:GET_INFO_ROAD_CONDITION Is there a [SL:ROAD_CONDITION snow storm ] blocking roads in [SL:LOCATION Placerville ] ]
any flood in the roads today	any flood in the roads today	[IN:GET_INFO_ROAD_CONDITION any [SL:ROAD_CONDITION flood ] in the roads [SL:DATE_TIME today ] ]
what are the road conditions between  Dallas and Houston if I leave now?	what are the road conditions between Dallas and Houston if I leave now ?	[IN:GET_INFO_ROAD_CONDITION what are the road conditions between [SL:SOURCE Dallas ] and [SL:DESTINATION Houston ] if I leave [SL:DATE_TIME_DEPARTURE now ] ? ]
Are the roads icy this evening?	Are the roads icy this evening ?	[IN:GET_INFO_ROAD_CONDITION Are the roads [SL:ROAD_CONDITION icy ] [SL:DATE_TIME this evening ] ? ]
Are the roads icy between here and Bonnie's house?	Are the roads icy between here and Bonnie 's house ?	[IN:GET_INFO_ROAD_CONDITION Are the roads [SL:ROAD_CONDITION icy ] between [SL:SOURCE [IN:GET_LOCATION [SL:LOCATION_USER here ] ] ] and [SL:DESTINATION [IN:GET_LOCATION_HOME [SL:CONTACT Bonnie ] 's house ] ] ? ]
At 6:00 are the roads to Beth's expected to be icy	At 6 : 00 are the roads to Beth 's expected to be icy	[IN:GET_INFO_ROAD_CONDITION [SL:DATE_TIME At 6 : 00 ] are the roads to [SL:DESTINATION [IN:GET_LOCATION_HOME [SL:CONTACT Beth ] ] ] 's expected to be [SL:ROAD_CONDITION icy ] ]
How snowy is the highway going to the  Jack-O-Lantern Contest?	How snowy is the highway going to the Jack - O - Lantern Contest ?	[IN:GET_INFO_ROAD_CONDITION How [SL:ROAD_CONDITION snowy ] is [SL:PATH [IN:GET_LOCATION [SL:CATEGORY_LOCATION the highway ] ] ] going to [SL:DESTINATION [IN:GET_EVENT [SL:CATEGORY_EVENT the Jack - O - Lantern Contest ] ] ] ? ]
Are the roads icy tonight	Are the roads icy tonight	[IN:GET_INFO_ROAD_CONDITION Are the roads [SL:ROAD_CONDITION icy ] [SL:DATE_TIME tonight ] ]
Is there flooding downtown by the Fort Pitt Bridge  going into town?	Is there flooding downtown by the Fort Pitt Bridge going into town ?	[IN:GET_INFO_ROAD_CONDITION Is there [SL:ROAD_CONDITION flooding ] [SL:LOCATION [IN:GET_LOCATION [SL:LOCATION downtown ] [SL:LOCATION_MODIFIER [IN:GET_LOCATION [SL:SEARCH_RADIUS by ] [SL:POINT_ON_MAP the Fort Pitt Bridge ] ] ] ] ] going into [SL:DESTINATION [IN:GET_LOCATION [SL:CATEGORY_LOCATION town ] ] ] ? ]
Is the road to St. Joe flooded still?	Is the road to St . Joe flooded still ?	[IN:GET_INFO_ROAD_CONDITION Is the road to [SL:DESTINATION St . Joe ] [SL:ROAD_CONDITION flooded ] still ? ]
Have they cleaned off the roads since the snow lastnight	Have they cleaned off the roads since the snow lastnight	[IN:GET_INFO_ROAD_CONDITION Have they cleaned off the roads since [SL:ROAD_CONDITION the snow ] [SL:DATE_TIME lastnight ] ]
